100 Man $ Kid - Maboroshi no Teiou Hen (J)	100万美元-幻之帝王篇(日)
10-Yard Fight (J)	10码大战-橄榄球大赛(日)
10-Yard Fight (U)	10码大战-橄榄球大赛(美)
1942 (JU)	1942(日美)
1943 (J)	1943(日)
1943 (U)	1943(美)
1999 - Hore, Mitakotoka! Seikimatsu (J)	1999强手棋(日)
3-D Battles of World Runner, The (U)	3D世界赛跑者(美)
3-in-1 Supergun (C)	3合1枪(日)
4 Nin Uchi Mahjong (J)	4人麻将(日)
720 (U)	滑板720度(美)
8 Eyes (J)	8只眼(日)
8 Eyes (U)	8只眼(美)
'89 Dennou Kyuusei Uranai (J)	89电脑占卜(日)
A Ressha de Ikou (J)	A列车(日)
Aa Yakyuu Jinsei Icchokusen (J)	呜呼!野球人生一直线(日)
Abadox (J)	阿贝道X(绝对合体)(日)
Abadox (U)	阿贝道X(绝对合体)(美)
Abarenbou Tengu (Zombie Nation) (J)	超级乌鸦天狗(日)
Aces - Iron Eagle 3 (J)	ACES铁鹰战机3(日)
Action 52 (U)	52合1(美))
Action 52 (E)	格斗52合1(欧)
Action in New York (E)	最终任务美版(空中魂斗罗美版)
AD&D Dragon Strike (U)	AD&D龙之猎手(美)
AD&D Dragons of Flame (J)	龙之矛-龙的火焰(日)
AD&D Heroes of the Lance (J)	AD&D长枪英雄(日)
AD&D Heroes of the Lance (U)	AD&D长枪英雄(美)
AD&D Hillsfar (U)	AD&D英雄冒险(美)
AD&D Hillsfar (J)	AD&D英雄冒险(日)
AD&D Pool of Radiance (J)	AD&D龙之战士(日)
AD&D Pool of Radiance (U)	AD&D龙之战士(美)
Addams Family - Pugsley's Scavenger Hunt, The (U)	阿达一族3(美)
Addams Family, The (U)	阿达一族(美)
Adventure Island Classic (E)	冒险岛1(欧)
Adventures in the Magic Kingdom (E)
Adventures in the Magic Kingdom (U)
Adventures of Bayou Billy, The (E)	鳄鱼先生(欧)
Adventures of Bayou Billy, The (U)	鳄鱼先生(美)
Adventures of Captain Comic, The (U)	宇宙船长冒险(美)
Adventures of Dino Riki (U)	新人类(美)
Adventures of Lolo (U)	罗罗大冒险(蛋王子)(美)
Adventures of Lolo (J)	罗罗大冒险(蛋王子)(日)
Adventures of Lolo 2 (J)	罗罗大冒险2(日)
Adventures of Lolo 2 (U)	罗罗大冒险2(美)
Adventures of Lolo 3 (U)	罗罗大冒险3(美)
Adventures of Rad Gravity, The (E)
Adventures of Rad Gravity, The (U)
Adventures of Rocky and Bullwinkle and Friends, The (U)	Rocky、Bullwinkle和朋友的冒险(美)
Adventures of Tom Sawyer (U)	小汤姆历险记(美)
After Burner (U)	冲破火网(美)
After Burner 2 (J)	冲破火网2(日)
Ai Sensei no Oshiete - Watashi no Hoshi (J)	爱先生的占卜之星(日)
Aigiina no Yogen - From The Legend of Balubalouk (J)	古代预言(日)
Air Fortress (J)	空中大作战(空中要塞)(日)
Air Fortress (U)	空中大作战(空中要塞)(美)
Airwolf (E)	空狼(欧)
Airwolf (J)	空狼(日)
Airwolf (U)	空狼(美)
Akagawa Jirou no Yuurei Ressha (J)	赤川次郎的幽灵列车(日)
Akira (J)
Akuma Kun - Makai no Wana (J)	恶魔君(日)
Akuma no Shoutaijou (J)	恶魔的邀请书(日)
Akumajou Densetsu (J)	恶魔城传说(恶魔城3)(日)
Akumajou Dracula (J)	恶魔城(日)
Akumajou Special - Boku Dracula Kun (J)	恶魔城外传-王子传奇(德拉克拉君)(日)
Al Unser Jr Turbo Racing (U)	超级方程式赛车(美)
Aladdin (E)	阿拉丁(欧)
Alfred Chicken (U)	神鸡艾烈佛(美)
Alien 3 (U)	异行3(美)
Alien Syndrome (J)	异行(日)
Alien Syndrome (U)	异行(美)
All-Pro Basketball (U)
Alpha Mission (U)	阿尔法任务(ASO战机)(美)
Amagon (U)	突然君(美)
America Daitouryou Senkyo (J)	美国大总统选举(日)
America Oudan Ultra Quiz - Shijou Saidai no Tatakai (J)	横断美国问答-史上最大的战斗(日)
American Dream (J)	柏青哥君美国之梦(派金宫君美国之梦)(日)
American Gladiators (U)	美国电视斗士(美)
Ankoku Shinwa - Yamato Takeru Densetsu (J)	暗黑神话(日)
Antarctic Adventure (J)	南极大冒险(日)
Anticipation (U)
Aoki Ookami to Shiroki Mejika - Genchou Hishi (J)	元朝秘史-成吉思汗(日)
Aoki Ookami to Shiroki Mejika - Genghis Khan (J)	元朝秘史2-苍狼与白鹿(日)
Arabian Dream Sherazaado (J)	阿拉伯之梦(日)
Arch Rivals (U)	双人篮球(日)
Archon (U)	巫术对弈(美)
Arctic (J)
Argos no Senshi (J)	未来战士(日)
Argus (J)	百眼巨神(日)
Arkanoid (J)	打砖块(日)
Arkanoid (U)	打砖块(美)
Arkanoid 2 (J)	打砖块2(日)
Arkista's Ring (U)
Armadillo (J)
Artelius (J)
Asmik Kun Land (J)	阿斯米君世界(日)
ASO - Armored Scrum Object (J)	ASO战机(日)
Asterix (E)
Astro Fang - Super Machine (J)	疯狂大赛车(日)
Astro Robo Sasa (J)	漂浮枪手(日)
Astyanax (Prototype) (U)	斧王(工程版)(美)
Astyanax (U)	斧王(美)
Athena (J)	雅典娜(日)
Athena (U)	雅典娜(美)
Athletic World (U)	田径运动会(美)
Atlantis no Nazo (J)	亚特兰蒂斯之迷(日)
Attack Animal Gakuen (J)	攻击动物学园(日)
Attack of the Killer Tomatoes (U)
Aussie Rules Footy (E)	体育集锦(欧)
AV Pachi Slot (J)	柏青嫂(派金宫嫂)
Babel no Tou (J)	巴比伦塔(日)
Baby Boomer (U)	保护Baby(美)
Back to the Future (U)	回到未来(美)
Back to the Future 2 & 3 (U)	回到未来2&3(美)
Bad Dudes (U)	龙之忍者(美)
Bad News Baseball (U)	坏消息棒球(美)
Bad Street Brawler (U)
BadDudes Vs DragonNinja (E)	黑街风云(欧)
Baken Hisshou Gaku - Gate In (J)	马券必胜学(日)
Bakushou Ai no Gekijou (J)	爆笑爱之剧场(日)
Bakushou Jinsei Gekijoh 3 (J)	爆笑人生剧场3(日)
Bakushou! Star Monomane Shitennou (J)	爆笑四天王(日)
Bakushou!! Jinsei Gekijoh (J)	爆笑人生剧场(日)
Bakushou!! Jinsei Gekijoh 2 (J)	爆笑人生剧场2(日)
Ballblazer (J)	滚球大战(日)
Balloon Fight (E)	气球大战(日)
Balloon Fight (JU)	气球大战(日美)
Baltron (J)	巴特龙战机(日)
Banana (J)	香蕉(日)
Banana Prince (G)	香蕉王子大冒险(美)
Bananan Ouji no Dai Bouken (J)	香蕉王子大冒险(日)
Bandai Golf - Challenge Pebble Beach (U)	Bandai高尔夫球(美)
Bandit Kings of Ancient China (U)
Bao Qing Tian (C)	包青天(中)
Barbie (Rev 3) (U)	芭芘娃娃(美)
Barbie (Rev X) (U)	芭芘娃娃(美)
Barcode World (J)	条码世界(日)
Bard's Tale - Tales of the Unknown, The (U)	秘境魔宝(美)
Bard's Tale - Tales of the Unknown, The (J)	秘境魔宝(日)
Bard's Tale 2 - The Destiny Knight, The (J)	秘境魔宝2(日)
Barker Bill's Trick Shooting (U)
Base Wars (U)	棒球(美)
Baseball (UE)	棒球(美欧)
Baseball (J)	棒球(日)
Baseball Fighter (J)	棒球大战(日)
Baseball Simulator 1.000 (U)	模拟棒球1000(美)
Baseball Star - Mezase Sankanou!! (J)
Baseball Stars (U)	棒球之星(美)
Baseball Stars 2 (U)	棒球之星2(美)
Bases Loaded (U)	棒球(美)
Bases Loaded 2 (U)	棒球2(美)
Bases Loaded 3 (U)	棒球3(美)
Bases Loaded 4 (U)	棒球4(美)
Batman (E)	蝙蝠侠(欧)
Batman (J)	蝙蝠侠(日)
Batman (Prototype) (U)	蝙蝠侠(工程版)(美)
Batman (U)	蝙蝠侠(美)
Batman - Return of the Joker (U)	蝙蝠侠-Joker归来(美)
Batman Returns (U)	蝙蝠侠的归来(美)
Batsu & Terii (J)
Battle Baseball (J)	SD战斗棒球(日)
Battle Chess (U)	战斗国际象棋(日)
Battle City (J)	坦克大战(日)
Battle Fleet (J)	大海战(日)
Battle Formula (J)	战斗方程赛车(日)
Battle of Olympus, The (E)	奥林匹斯之战(欧)
Battle of Olympus, The (U)	奥林匹斯之战(美)
Battle Stadium - Senbatsu Pro Yakyuu (J)	战斗棒球大赛(日)
Battle Storm (J)	战斗风暴(日)
Battle Tank (U)	战斗坦克(美)
Battleship (U)	战斗舰船(美)
Battletoads (E)	忍者蛙(欧)
Battletoads (J)	忍者蛙(日)
Battletoads (U)	忍者蛙(美)
Battletoads Double Dragon (E)	忍者蛙与双截龙(欧)
Battletoads Double Dragon (U)	忍者蛙与双截龙(美)
Beauty and the Beast (E)	美女与野兽(欧)
Be-Bop-Highschool - Koukousei Gokuraku Densetsu (J)	高校生极乐传说(日)
Bee 52 (U)	蜜峰52(美)
Beetlejuice (U)	阴间大法师/哗鬼家族(美)
Best Keiba - Derby Stallion (J)
Best of the Best Championship Karate (U)
Best Play Pro Yakyuu (J)	亚斯基职业野球(日)
Best Play Pro Yakyuu (Shin Data) (J)	亚斯基职业野球(日)
Best Play Pro Yakyuu 2 (J)	亚斯基职业野球2(日)
Best Play Pro Yakyuu '90 (J)	亚斯基职业野球'90(日)
Best Play Pro Yakyuu Special (J)	亚斯基职业野球特别篇(日)
Bible Adventures (V1.2) (U)	圣经大冒险V1.2(美)
Bible Adventures (V1.3) (U)	圣经大冒险V1.3(美)
Bible Buffet (Ver 6.0) (U)
Big Bird's Hide and Speak (U)	大鸟学英语(美)
Big Nose Freaks Out (U)	大鼻子怪人(美)
Big Nose Freaks Out (Aladdin) (U)	大鼻子怪人(美)
Big Nose the Caveman (U)	大鼻子原始人(美)
Bigfoot (U)	大轮赛车(日)
Bikkuri Nekketsu Shin Kiroku! - Harukanaru Kin Medal (J)	热血新记录(日)
Bikkuriman World - Gekitou Sei Senshi (J)	激斗圣战士(日)
Bill & Ted's Excellent Video Game Adventure (U)	比尔和特德的电子游戏世界冒险(美)
Bill Elliott's NASCAR Challenge (U)
Binary Land (J)	企鹅先生(日)
Bing Kuang Ji Dan Zi - Flighty Chicken (C)
Bio Miracle Bokutte Upa (J)	超级宝宝(日)
Bio Senshi Dan - Increaser tono Tatakai (J)	超级战士-DAN(日)
Bionic Commando (E)	希特勒复活(欧)
Bionic Commando (U)	希特勒复活(美)
Bird Week (J)	鸟的故事(日)
Black Bass 2, The (J)	黑巴斯2(日)
Black Bass USA, The (U)	黑巴斯(美)
Black Bass, The (J)	黑巴斯(日)
Blackjack (U)	黑杰克(21点)
Blades of Steel (E)	曲棍球(欧)
Blades of Steel (U)	曲棍球(美)
Blaster Master (E)	变形坦克(欧)
Blaster Master (Prototype) (U)	变形坦克(工程版)(美)
Blaster Master (U)	变形坦克(美)
Blodia Land - Puzzle Quest (J)	方块世界(日)
Bloody Warriors - Shan-Go no Gyakushuu (J)	血之战士(日)
Blue Marlin, The (J)	蓝色马林(日)
Blue Marlin, The (U)	蓝色马林(美)
Blue Shadow (E)	赤影战士(欧)
Blues Brothers, The (U)	蓝色兄弟(美)
Bo Jackson Baseball (U)	杰克逊棒球(美)
Bokosuka Wars (J)	武士救美(日)
Bomber King (J)	炸弹之王(日)
Bomberman (J)	炸弹人(日)
Bomberman (U)	炸弹人(美)
Bomberman 2 (J)	炸弹人2(日)
Bomberman 2 (U)	炸弹人2(美)
Bonk's Adventure (U)	FC原人(美)
Booby Kids (J)	时空小子(日)
Boulder Dash (E)	新地底探险(欧)
Boulder Dash (J)	新地底探险(日)
Boulder Dash (U)	新地底探险(美)
Boy and His Blob - Trouble on Blobolonia, A (E)
Boy and His Blob - Trouble on Blobolonia, A (U)
Bram Stoker's Dracula (E)	德拉克拉伯爵(欧)
Bram Stoker's Dracula (U)	德拉克拉伯爵(美)
Break Time (U)	休息时间(美)
Breakthru (U)
Brush Roller (C)	刷子与滚筒(中)
Bubble Bath Babes (UE)	气泡方块(美欧)
Bubble Bobble (E)	气泡方块(欧)
Bubble Bobble (U)	气泡方块(美)
Bubble Bobble 2 (J)	气泡方块2(日)
Bubble Bobble Part 2 (U)	气泡方块(美)
Bucky O'Hare (U)	外星战将(美)
Bucky O'Hare (E)	外星战将(欧)
Bucky O'Hare (J)	外星战将(日)
Buggy Popper (J)	公路追逐赛(日)
Bugs Bunny Birthday Blowout, The (E)	兔八哥生日快乐(欧)
Bugs Bunny Birthday Blowout, The (U)	兔八哥生日快乐(美)
Bugs Bunny Crazy Castle, The (U)	宾尼兔(美)
Bugs Bunny Fun House (Prototype) (U)	宾尼兔的快乐房子(工程版)(美)
Bump'n'Jump (U)	公路追逐赛(美)
Burai Fighter (J)	无赖战士(日)
Burai Fighter (U)	无赖战士(美)
Burger Time (U)	汉堡时代(美)
Burger Time (J)	汉堡时代(日)
Business Wars (J)	商业战争(日)
B-Wings (J)	B计划(日)
Cabal (U)	勇士们(美)
Cadillac (J)	扑克方块(日)
Caesar's Palace (U)	吃角子老虎机(日)
California Games (E)	加州游戏(欧)
California Games (U)	加州游戏(美)
Caltron 6-in-1 (U)	卡特龙-六合一(美)
Capcom Barcelona '92 (J)	卡普空-92年 巴塞罗那奥运会(日)
Captain America and the Avengers (U)	美国上尉(美)
Captain Ed (J)	ED上尉(日)
Captain Planet and the Planeteers (U)	行星上尉(美)
Captain Saver (J)	救援上尉(日)
Captain Silver (J)	银色上尉(日)
Captain SkyHawk (U)	隼鹰上尉(美)
Captain Tsubasa (J)	天使之翼(足球小将)(日)
Captain Tsubasa Vol 2 - Super Striker (J)	天使之翼2(足球小将2)-超级前锋(日)
Casino Derby (J)	竞马赛场(日)
Casino Kid (U)	赌城小子(美)
Casino Kid 2 (U)	赌城小子2(美)
Castelian (E)	卡斯特里安(欧)
Castelian (U)	卡斯特里安(美)
Castle Excellent (J)	城堡探险(日)
Castle of Deceit (U)
Castle of Dragon (U)	龙之堡垒(美)
Castle Quest (J)	勇者之城(日)
Castle Quest (U)	勇者之城(美)
Castlevania (E)	恶魔城-卡斯特瓦尼亚(欧)
Castlevania (PRG 1) (U)	恶魔城-卡斯特瓦尼亚(PRG1)(美)
Castlevania (U)	恶魔城-卡斯特瓦尼亚(美)
Castlevania 2 - Simon's Quest (E)	恶魔城-卡斯特瓦尼亚Ⅱ(欧)
Castlevania 2 - Simon's Quest (U)	恶魔城-卡斯特瓦尼亚Ⅱ(美)
Castlevania 3 - Dracula's Curse (E)	恶魔城-卡斯特瓦尼亚Ⅲ-德拉库拉的诅咒(欧)
Castlevania 3 - Dracula's Curse (U)	恶魔城-卡斯特瓦尼亚Ⅲ-德拉库拉的诅咒(美)
Cattou Ninden Teyandee (J)	忍者猫(日)
Caveman Games (U)	原始人运动会(日)
Caveman Ninja (E)	原始忍者(欧)
Chack 'n Pop (J)	流行恰克(日)
Challenge of the Dragon (U)	挑战神龙(美)
Challenger (J)	列车寻宝(日)
Championship Bowling (U)	保龄球大赛(美)
Championship Bowling (J)	保龄球大赛(日)
Championship Lode Runner (J)	淘金者(日)
Championship Pool (U)	台球锦标赛(美)
Championship Rally (U)	冠军集合(美)
Chaos World (J)	混沌世界(日)
Cheetahmen 2 (U)
Chessmaster, The (U)	象棋大师(美)
Chester Field - Ankoku Shin heno Chousen (J)	暗黑领域(日)
Chibi Maruko Chan - Uki Uki Shopping (J)	樱桃小丸子(日)
Chiisana Obake - Acchi Socchi Kocchi (J)
Chiki Chiki Machine Mou Race (J)	顽皮狗(日)
Chiller (U)
Chip 'n Dale Rescue Rangers (U)	松鼠大作战(美)
Chip 'n Dale Rescue Rangers (E)	松鼠大作战(欧)
Chip 'n Dale Rescue Rangers 2 (U)	松鼠大作战2(美)
Chip to Dale no Dai Sakusen (J)	松鼠大作战(日)
Chip to Dale no Dai Sakusen 2 (J)	松鼠大作战2(日)
Chitei Senkuu Vazorudaa (J)	地底大作战(日)
Chiyo no Fuji no Ooichou (J)	千代大相扑(日)
Choplifter (J)	直升机大战(日)
Chou Hen (Joy Van) (J)	仇恨(日)
Chou Jikuu Yousai - Macross (J)	超时空要塞(日)
Chou Jinrou Senki - Warwolf (J)	超人狼战记(日)
Chou Wakusei Senki - Metafight (J)	超惑星战记(日)
Choujin - Ultra Baseball (J)	超人棒球(日)
Choujin Sentai - Jetman (J)	鸟人战队(日)
Chu Da D (C)
Chu Han Zheng Ba - The War Between Chu & Han (C)	楚汉争霸(中)
Chubby Cherub (U)	爱天使(Q太郎美版)(日)
Chuka Taisen (J)	中华对战(日)
Chuugoku Janshi Story - Tonpuu (J)	东风-中国麻将(日)
Chuugoku Senseijutsu (J)	中国占星术(日)
Circus Caper (U)	马戏团(美)
Circus Charlie (J)	马戏团(日)
City Adventure Touch - Mystery of Triangle (J)	城市冒险-接触(日)
City Connection (J)	碰碰车(日)
City Connection (U)	碰碰车(美)
Clash At Demonhead (U)	恶魔领袖(美)
Classic Concentration (U)	经典集中营(美)
Cliffhanger (U)	颠峰战士(美)
Clu Clu Land (JU)	库鲁库鲁大陆(日,美)
Cobra Command (J)	眼镜蛇指挥官(日)
Cobra Command (U)	眼镜蛇指挥官(美)
Cobra Triangle (E)	三角眼镜蛇(欧)
Cobra Triangle (U)	三角眼镜蛇(美)
Cocoron (J)	魔法世界(日)
Code Name Viper (U)	蝰蛇行动(美)
Color A Dinosaur (U)	彩色恐龙(美)
Columbus - Ougon no Yoake (J)	哥伦布传(日)
Commando (U)	战场之狼(美)
Conan (U)	柯南(美)
Conflict (U)	三军大作战(美)
Conflict (J)	三军大作战(日)
Conquest of the Crystal Palace (U)	水晶宫殿之征服者(美)
Contra (U)	魂斗罗(美)
Contra Force (U)	魂斗罗-力量(美)
Cool World (U)	冷酷世界(美)
Corvette ZR-1 Challenge (E)	ZR-1的挑战(欧)
Cosmic Epsilon (J)	宇宙战机(日)
Cosmic Wars (J)	宇宙大作战(日)
Cosmo Genesis (J)	宇宙创世纪(日)
Cosmo Police - Galivan (J)	宇宙刑警(日)
Cowboy Kid (U)	牛仔小子(美)
Crackout (E)	裂缝(欧)
Crash'n The Boys Street Challenge (U)	街头小子(美)
Crayon Shin Chan - Ora to Poi Poi (J)	蜡笔小新(日)
Crazy Climber (J)	疯狂攀爬(日)
Crisis Force (J)	危机力量(日)
Cross Fire (J)	交叉火力(日)
Crystal Mines (U)	晶莹的我(美)
Crystalis (U)	克瑞斯达思(美)
Crystalis (Prototype) (U)	克瑞斯达思(工程版)(美)
Cyberball (U)	西巴球(美)
Cybernoid - The Fighting Machine (U)	战斗机器-塞博诺德(美)
Cycle Race - Road Man (J)	单车王(日)
Dai 2 Ji - Super Robot Taisen (J)	第2次超级机器人大战(日)
Dai Kaijuu - Deburas (J)	大怪兽-德布拉斯(日)
Dai Koukai Jidai (J)	大航海时代(日)
Dai Meiro - Meikyuu no Tatsujin (J)	大迷路(日)
Dai Senryaku (J)	大战略(日)
Daiku no Gen San (J)	大力工头-阿源君(日)
Daiku no Gen San 2 - Akage no Dan no Gyakushuu (J)	大力工头2-阿源君(日)
Daiva - Imperial of Nirsartia (J)	超人迪瓦(日)
Dance Aerobics (U)	家庭游戏-艺术体操训练美版(韵律体操美版)
Danny Sullivan's Indy Heat (U)	印地之热赛车(美)
Dark Lord (J)	暗黑领主(日)
Darkman (U)	上海教父(美)
Darkwing Duck (E)	怪鸭历险记(欧)
Darkwing Duck (Prototype) (U)	怪鸭历险记(工程版)(美)
Darkwing Duck (U)	怪鸭历险记(美)
Dash Galaxy in the Alien Asylum (U)	银河避难所(美)
Dash Yarou (J)	冲刺野郎(日)
Datach - Battle Rush - Build Up Robot Tournament (J)	条码版战斗机器人(日)
Datach - Crayon Shin Chan - Ora to Poi Poi (J)	蜡笔小新条码版(日)
Datach - Dragon Ball Z - Gekitou Tenkaichi Budou Kai (J)	七龙珠Z-激斗天下一武道会(日)
Datach - J League Super Top Players (J)	J联盟条码足球(日)
Datach - SD Gundam - Gundam Wars (J)	SD高达条码版(日)
Datach - Ultraman Club - Supokon Fight! (J)	超人俱乐部(日)
Datach - Yuu Yuu Hakusho - Bakutou Ankoku Bujutsu Kai (J)	幽游白书(日)
Datsugoku (J)	脱狱(日)
Day Dreamin' Davey (U)	梦幻日子(美)
Days of Thunder (U)	雷鸣之日(美)
Deadly Towers (U)	致命大厦(美)
Deathbots (U)	毁灭机器(美)
Deblock (J)	星际俄罗斯方块(日)
Decathlon (C)	迪剀瑟龙(日)
Deep Dungeon 3 - Yuushi heno Tabi (J)	深入地底3(日)
Deep Dungeon 4 - Kuro no Youjutsushi (J)	深入地底4(日)
Defender 2 (U)	防御者2(美)
Defender of the Crown (E)	王冠守卫战(欧)
Defender of the Crown (U)	王冠守卫战(美)
Defenders of Dynatron City (U)	保卫城市(欧)
Deja Vu (J)	逃脱者(日)
Deja Vu (NL)	逃脱者(欧)
Deja Vu (U)	逃脱者(美)
Demon Sword (U)	魔灵之剑(美)
Dengeki - Big Bang! (J)	电击作战(日)
Densetsu no Kishi - Elrond (J)	骑士传说(日)
Derby Stallion - Zenkoku Ban (J)	德比赛马全国版(日)
Desert Commander (U)	沙漠之狐(美)
Destination Earthstar (U)	目标地球(美)
Destiny of an Emperor (U)	吞食天地(日)
Devil Man (J)	恶魔人(日)
Devil World (E)	鬼灵世界(欧)
Devil World (J)	鬼灵世界(日)
Dezaemon (J)	描绘卫门(设计卫门)(日)
Dick Tracy (U)	迪克侦探(美)
Die Hard (J)	坚硬金属(日)
Die Hard (U)	坚硬金属(美)
Dig Dug (J)	挖金子(日)
Dig Dug II (U)	挖金子2(美)
Dig Dug II (J)	挖金子2(日)
Digger - The Legend of the Lost City (U)	失落城市传说(美)
Digger T. Rock - The Legend of the Lost City (E)	失落城市传说(欧)
Digital Devil Story - Megami Tensei (J)	女神转生(日)
Digital Devil Story - Megami Tensei 2 (J)	女神转生2(日)
Dirty Harry (U)	脏脏的哈里(美)
Dizzy The Adventurer (Aladdin) (U)	小蛋大冒险(美)
Doctor PC Jr. - Xue Si Dian Nao (C)	学习电脑(中)
Doki! Doki! Yuuenchi (J)	游园地(日)
Dokuganryuu Masamune (J)	独眼龙正宗(日)
Don Doko Don (J)	工人战记(咚咚)(日)
Don Doko Don 2 (J)	工人战记2(咚咚)(日)
Donald Duck (J)	唐老鸭(日)
Donald Land (J)	麦当劳大陆(日)
Dong Fang de Chuan Shuo - The Hyrule Fantasy (C)	东方的传说(中)
Donkey Kong (JU)	大金刚(日,美)
Donkey Kong 3 (JUE)	大金刚3(日,美,欧)
Donkey Kong Classics (U)	经典大金刚(美)
Donkey Kong Jr. (JU)	Jr大金刚(日,美)
Donkey Kong Jr. + Jr. Lesson (J)	Jr大金刚-课程(日)
Donkey Kong Jr. Math (U)	Jr大金刚-数学(美)
Donkey Kong Jr. no Sansuu Asobi (J)	Jr大金刚-数学(日)
Door Door (J)	门门(日)
Door Door FDS [f1] (J)	门门FDS(日)
Doraemon (J)	机器猫-哆啦A梦(日)
Doraemon - Gigazombie no Gyakushuu (J)	机器猫小叮当冒险RPG(日)
Double Dare (U)	保龄球挑战(美)
Double Dragon (E)	双截龙(欧)
Double Dragon (J)	双截龙(日)
Double Dragon (U)	双截龙(美)
Double Dragon 2 - The Revenge (J)	双截龙Ⅱ-复仇(日)
Double Dragon 2 - The Revenge (U)	双截龙Ⅱ-复仇(美)
Double Dragon 3 - The Rosetta Stone (J)	双截龙Ⅲ-罗塞塔之石(日)
Double Dragon 3 - The Sacred Stones (E)	双截龙Ⅲ-罗塞塔之石(欧)
Double Dragon 3 - The Sacred Stones (U)	双截龙Ⅲ-罗塞塔之石(美)
Double Dribble (PRG 1) (U)	双重液体(PRG)(美)
Double Dribble (U)	双重液体(美)
Double Moon Densetsu (J)	双月传说(日)
Double Strike (V1.0) (U)	双重打击者V1.0(美)
Double Strike (V1.1) (U)	双重打击者V1.1(美)
Dough Boy (J)	美国大兵(日)
Downtown - Nekketsu Koushin Kyoku - Soreyuke Dai Undoukai (J)	热血进行曲(日)
Downtown - Nekketsu Monogatari (J)	热血物语(日)
Downtown Special - Kunio Kun no Jidaigeki Dayo Zenin Shuugou! (J)	特别剧场(日)
Dr Chaos (U)	混沌博士(美)
Dr Jekyll and Mr Hyde (U)	仿魔之刻(美)
Dr Mario (E)	玛丽医生(欧)
Dr Mario (JU)	玛丽医生(日,美)
Drac's Night Out (Prototype) (U)	复活之夜(工程版)(美)
Dragon Ball - Dai Maou Fukkatsu (J)	七龙珠2-大魔王复活(日)
Dragon Ball - Le Secret Du Dragon (F)	七龙珠-神龙之迷(欧)
Dragon Ball - Shen Long no Nazo (J)	七龙珠-神龙之迷(日)
Dragon Ball 3 - Gokuu Den (J)	七龙珠Ⅲ-悟空传(日)
Dragon Ball Z - Kyoushuu! Saiya Jin (J)	七龙珠Z-强袭!塞亚人(日)
Dragon Ball Z 2 - Gekishin Freeza!! (J)	七龙珠Z2-激斗弗利萨(日)
Dragon Ball Z 3 - Ressen Jinzou Ningen (J)	七龙珠Z3-烈战人造人(日)
Dragon Ball Z Gaiden - Saiya Jin Zetsumetsu Keikaku (J)	七龙珠Z外传-塞亚人灭绝计划(日)
Dragon Buster (J)	倚天屠龙记(日)
Dragon Buster 2 - Yami no Fuuin (J)	倚天屠龙记2(日)
Dragon Fighter (J)	龙战士(日)
Dragon Fighter (U)	龙战士(美)
Dragon Ninja (J)	龙之忍者(欧)
Dragon Power (U)	七龙珠-神龙之谜(美)
Dragon Quest (J)	勇者斗恶龙(日)
Dragon Quest 2 (J)	勇者斗恶龙Ⅱ(日)
Dragon Quest 3 (J)	勇者斗恶龙Ⅲ(日)
Dragon Quest 4 (J)	勇者斗恶龙Ⅳ(日)
Dragon Scroll - Yomigaerishi Maryuu (J)	复活魔龙(龙之卷轴)(日)
Dragon Slayer 4 - Drasle Family (J)	屠龙记4(日)
Dragon Spirit - Aratanaru Densetsu (J)	龙魂-新的传说(日)
Dragon Spirit - The New Legend (U)	龙魂-新的传说(美)
Dragon Unit (J)	龙之军团(龙之城堡)(日)
Dragon Warrior (PRG 1) (U)	勇者斗恶龙(PRG 1)(美)
Dragon Warrior (U)	勇者斗恶龙(美)
Dragon Warrior 2 (U)	勇者斗恶龙2(美)
Dragon Warrior 3 (U)	勇者斗恶龙3(美)
Dragon Warrior 4 (U)	勇者斗恶龙4(美)
Dragon Wars (J)	神龙战争(日)
Dragon, The (C)	龙王(中)
Dragon's Lair (E)	龙之巢穴(欧)
Dragon's Lair (J)	龙之巢穴(日)
Dragon's Lair (U)	龙之巢穴(美)
Dream Master (J)	梦境之王(日)
Drop Zone (E)	跌落地带(欧)
Duck Hunt (JUE)	猎鸭-光枪版(日,美,欧)
Duck Tales (E)	唐老鸭梦冒险(欧)
Duck Tales (Prototype) (U)	唐老鸭梦冒险(工程版)(美)
Duck Tales (U)	唐老鸭梦冒险(美)
Duck Tales 2 (J)	唐老鸭梦冒险2(日)
Duck Tales 2 (U)	唐老鸭梦冒险2(美)
Dudes With Attitude (U)	多德的态度(美)
Dungeon & Magic - Swords of Element (J)	地下城与魔法-元素之剑(日)
Dungeon Kid (J)	迷宫小子(日)
Dungeon Magic - Sword of the Elements (U)	地下城与魔法-元素之剑(美)
Duo Bao Xiao Ying Hao - Guang Ming yu An Hei Chuan Shuo (C)	夺宝小英豪-光明与暗黑的传说(中)
Dusty Diamond's All-Star Softball (U)	全明星垒球(美)
Dynablaster (E)	炸弹人2(美)
Dynamite Batman (J)	蝙蝠侠(日)
Dynamite Bowl (J)	爆烈保龄球(日)
Dynowarz - Destruction of Spondylus (U)	毁灭的斯邦迪那斯(美)
Earth Bound (Prototype) (U)	妈妈(工程版)(美)
Earth Bound Zero (Neo Demiforce v1.01 Hack-1) (U)	妈妈0(黑客版)(美)
Earth Bound Zero (Neo Demiforce v1.01 Hack-2) (U)	妈妈0(黑客版)(美)
Edu (C)	学习机学习卡(中)
Eggerland - Meikyuu no Fukkatsu (J)	罗罗大冒险外传(日)
Egypt (J)	埃及(日)
Elevator Action (J)	电梯迷宫(日)
Elevator Action (U)	电梯迷宫(美)
Eliminator Boat Duel (U)	赛艇决战(美)
Elite (E)	银河侵略者(欧)
Elysion (J)	Elysion(日)
Emo Yan no 10 Bai Pro Yakyuu (J)	10倍力量职业棒球(日)
Erika to Satoru no Yume Bouken (J)	少年梦冒险(日)
Erunaaku no Zaihou (J)	艾鲁那财宝(日)
Esper Bouken Tai (J)	冒险队(日)
Esper Dream 2 - Aratanaru Tatakai (J)	世界之梦2(日)
Evert & Lendl Top Player's Tennis (U)	10人网球赛(美)
Excitebike (E)	越野摩托车(欧)
Excitebike (JU)	越野摩托车(日,美)
Exciting Boxing (J)	火爆拳击(日)
Exciting Rally - World Rally Championship (J)	火爆拉力赛车(日)
Exed Exes (J)	火凤凰(日)
Exerion (J)
Exodus (V4.0) (U)
F1 Circus (J)	F1竞赛场(日)
F-1 Race (J)	F1赛车(日)
F-1 Sensation (E)	新F1赛车(欧)
F-1 Sensation (J)	新F1赛车(日)
F-117a Stealth Fighter (U)	F-117A隐形战斗机(美)
F-15 City War (U)	F-15城市大战(美)
F-15 Strike Eagle (U)	F-15打击之鹰(美)
Famicom Disk System BIOS (J)	FC磁碟机BIOS文件(日)
Famicom Doubutsu Seitai Zukan! - Katte ni Shirokuma - Mori wo Sukue no Maki!(J)
Famicom Igo Nyuumon (J)	家庭围棋入门(日)
Famicom Jump - Eiyuu Retsuden (J)	英雄列传(日)
Famicom Jump 2 - Saikyou no 7 Nin (J)	英雄列传2(日)
Famicom Meijin Sen (J)	任天堂围棋名人战(日)
Famicom Shougi - Ryuuousen (J)	家庭将棋龙王战(日)
Famicom Top Management (J)	顶尖经营者(日)
Famicom Wars (J)	任天堂战争(日)
Famicom Yakyuu Ban (J)	任天堂棒球(日)
Family BASIC (V2.0a) (J)	FC的Basic语言文件(V2.0a)(日)
Family BASIC (V2.1a) (J)	FC的Basic语言文件(V2.1a)(日)
Family BASIC (V3.0) (J)	FC的Basic语言文件(V3.0a)(日)
Family Block (J)	家庭方块(日)
Family Boxing (J)	家庭拳击赛(日)
Family Circuit (J)	家庭赛车(日)
Family Circuit '91 (J)	家庭赛车 '91(日)
Family Computer - Othello (J)	家庭五子棋(奥赛罗棋磁碟机版)(日)
Family Feud (U)	Family Feud(美)
Family Jockey (J)	家庭赛马(日)
Family Mahjong (J)	家庭麻将(日)
Family Mahjong 2 - Shanghai Heno Michi (J)	家庭麻将2-上海之道(日)
Family Quiz (J)	家庭问答(趣味问答)(日)
Family School (J)	家庭学校(日)
Family Tennis (J)	家庭网球(日)
Family Trainer - Aerobics Studio (J)	家庭游戏-艺术体操训练(韵律体操)
Family Trainer - Athletic World (J)	田径运动会(日)
Family Trainer - Dai Undoukai (J)	大运动会(日)
Family Trainer - Fuuun Takeshi Jou 2 (J)	家庭游戏-突击风云城2(日)
Family Trainer - Jogging Race (J)	皇室赛车(日)
Family Trainer - Manhattan Police (J)	街头警察(日)
Family Trainer - Meiro Dai Sakusen (J)	迷路大作战(日)
Family Trainer - Rairai Kyonshiizu (J)	未来僵尸(日)
Family Trainer - Running Stadium (J)	家庭游戏体感田径赛(日)
Family Trainer - Totsugeki Fuuun Takeshi Jou (J)	家庭游戏-突击风云城(日)
Famista '89 - Kaimaku Ban!! (J)	法米斯塔'89(日)
Famista '90 (J)	法米斯塔'90(日)
Famista '91 (J)	法米斯塔'91(日)
Famista '92 (J)	法米斯塔'92(日)
Famista '93 (J)	法米斯塔'93(日)
Famista '94 (J)	法米斯塔'94(日)
Fantastic Adventures of Dizzy, The (U)	小蛋大冒险(美)
Fantastic Adventures of Dizzy, The (1993 Version) (U)	小蛋大冒险(1993年版本)(美)
Fantastic Adventures of Dizzy, The (Aladdin) (UE)	眩晕大冒险(美,欧)
Fantasy Zone (J)	幻想地带(日)
Fantasy Zone (U)	幻想地带(美)
Fantasy Zone 2 - The Teardrop of Opa-Opa (J)	幻想地带2(日)
Faria (J)	法利亚(日)
Faria (U)	法利亚(美)
Faxanadu (E)	沙纳多(欧)
Faxanadu (J)	沙纳多(日)
Faxanadu (U)	沙纳多(美)
FC Genjin - Freakthoropus Computerus (J)	FC原人(日)
Felix the Cat (U)	加菲猫(美)
Ferrari - Grand Prix Challenge (U)	法拉利大赛车(美)
Ferrari - Grand Prix Challenge (J)	法拉利大赛车(日)
Fester's Quest (Prototype) (U)	爱登斯家族(工程版)(美)
Fester's Quest (U)	爱登斯家族(美)
Field Combat (J)	杀戮战场(日)
Fighting Golf (J)	战斗高尔夫(日)
Fighting Road (J)	战斗之道(日)
Final Fantasy (J)	最终幻想(日)
Final Fantasy (U)	最终幻想(美)
Final Fantasy 1 & 2 (J)	最终幻想1+2(日)
Final Fantasy 2 (J)	最终幻想2(日)
Final Fantasy 3 (J)	最终幻想3(日)
Final Lap (J)	最终跑道(日)
Final Mission (J)	最终任务(空中魂斗罗)(日)
Fire Emblem (J)	火焰之纹章(日)
Fire Emblem Gaiden (J)	火焰之纹章-外传(日)
Fire Hawk (U)	战火隼鹰(美)
Fire 'n Ice (U)	所罗门之匙2(美版)
Firehouse Rescue (U)	火屋特急(美)
Fist of the North Star (U)	北斗之拳(美)
Flappy (J)	福莱皮(日)
Fleet Commander (J)	紧急命令(日)
Flight of the Intruder (U)	劫持航班(美)
Flintstones - The Rescue of Dino & Hoppy, The (E)	摩登原始人(欧)
Flintstones - The Rescue of Dino & Hoppy, The (J)	摩登原始人(日)
Flintstones - The Rescue of Dino & Hoppy, The (U)	摩登原始人(美)
Flintstones 2 - The Surprise at Dinosaur Peak!, The (U)	摩登原始人2(美)
Flipull - An Exciting Cube Game (J)	趣味方块(日)
Flying Dragon - The Secret Scroll (U)	飞龙之拳-卷轴之谜(美)
Flying Hero (J)	救火英雄(日)
Flying Warriors (U)	飞龙之拳(美)
Formation Z (J)	变形战机(日)
Formula One Built To Win (U)	建筑公式(美)
Foton - The Ultimate Game on Planet Earth (J)	地球最后之日(日)
Four Players Tennis (E)	四人网球(欧)
Frankenstein - The Monster Returns (U)	复苏怪兽(美)
Free Fall (Prototype) (U)	轻松秋季(工程版)(美)
Freedom Force (U)	自由力量(美)
Friday the 13th (U)	黑色13(日)
Front Line (J)	前线(日)
Fudou Myouou Den (J)	不动明王传(日)
Fun House (U)	滑稽小屋(日)
Fushigi no Umi no Nadia (J)	不可思议之海(日)
Fushigina Bloby - Blobania no Kiki (J)	不可思议之海(日)
Fuzzical Fighter (J)	奇幻勇士(日)
Galactic Crusader (Sachen) (U)	龙牙(美)
Galaga (J)	大蜜蜂(日)
Galaga (U)	大蜜蜂(美)
Galaxian (J)	小蜜蜂(日)
Galaxy 5000 (E)	银河五千年(欧)
Galaxy 5000 (U)	银河五千年(美)
Galg (J)	首领战舰(日)
Gambler Jiko Chuushin Ha - Mahjong Game (J)	自我中心派麻将(日)
Gambler Jiko Chuushin Ha 2 (J)	自我中心派麻将2(日)
Game Party (J)	游戏派对(日)
Ganbare Goemon 2 (J)	大盗伍佑卫门2(日)
Ganbare Goemon Gaiden - Kieta Ougon Kiseru (J)	大盗伍佑卫门外传-黄金财宝(日)
Ganbare Goemon Gaiden 2 - Tenka no Zaihou (J)	大盗伍佑卫门外传2-天下财宝(日)
Ganbare Goemon! - Karakuri Douchuu (J)	大盗伍佑卫门(日)
Ganbare Pennant Race! (J)	棒球锦标赛(日)
Ganso Saiyuuki - Super Monkey Dai Bouken (J)	西游记(日)
Garfield - A Week of Garfield (J)	加菲猫(日)
Gargoyle's Quest 2 - The Demon Darkness (E)	兽人任务-暗黑恶魔(欧)
Gargoyle's Quest 2 - The Demon Darkness (U)	兽人任务-暗黑恶魔(美)
Gauntlet (U)	铁手套(美)
Gauntlet 2 (E)	铁手套2(欧)
Gauntlet 2 (U)	铁手套2(美)
Gegege no Kitarou - Youkai Dai Makyou (J)	鬼太郎-妖怪大魔境(日)
Gegege no Kitarou 2 - Youkai Gundan no Chousen (J)	鬼太郎2-妖怪军团挑战(日)
Geimos (J)	宇宙大射击(日)
Gekikame Ninja Den (J)	激龟忍者传(日)
Gekitotsu Yonku Battle (J)	激斗四驱车(日)
Gekitou Puroresu!! - Toukon Densetsu (J)	激斗 美式-当今传说(日)
Gekitou Stadium!! (J)	激斗tecmo棒球(日)
Gemfire (U)	火焰宝石(美)
Genghis Khan (U)	元朝秘史(美)
Genpei Touma Den - Computer Boardgame (J)	源平讨魔传(日)
George Foreman's KO Boxing (U)	格斗拳击(美)
Getsufuu Maden (J)	月风魔传(日)
Ghostbusters (J)	魔鬼克星(日)
Ghostbusters (U)	魔鬼克星(美)
Ghostbusters 2 (U)	魔鬼克星2(美)
Ghosts'n Goblins (E)	哥布林小鬼(欧)
Ghosts'n Goblins (U)	哥布林小鬼(美)
Ghoul School (U)	幽灵校园(美)
GI Joe (U)	眼镜蛇部队(美)
GI Joe - The Atlantis Factor (U)	眼镜蛇部队-亚特兰迪斯之元素(美)
Gilligan's Island (U)	格里刚之大陆(美)
Gimmi a Break - Shijou Saikyou no Quiz Ou Ketteisen (J)	史上最强问答王决定战(日)
Gimmi a Break - Shijou Saikyou no Quiz Ou Ketteisen 2 (J)	史上最强问答王决定战2(日)
Gimmick! (J)	噱头(日)
Ginga Eiyuu Densetsu (J)	银河英雄传说(日)
Ginga no Sannin (J)	银河三人组(日)
Goal! (E)	足球GOAL!(欧)
Goal! (U)	足球GOAL!(美)
Goal! 2 (E)	足球GOAL2!(欧)
Goal! Two (U)	足球GOAL2!(美)
Goal!! (J)	足球GOAL!(日)
God Slayer - Haruka Tenkuu no Sonata (J)	弑神者-遥远天空之索那塔(日)
Godzilla (J)	哥吉拉(日)
Godzilla - Monster of Monsters! (E)	哥吉拉-怪兽大对决(欧)
Godzilla - Monster of Monsters! (U)	哥吉拉-怪兽大对决(美)
Godzilla 2 - War of the Monsters (U)	哥吉拉2-怪兽大战(美)
Gold Medal Challenge '92 (U)	足球Goal'92(美)
Golf (E)	高尔夫(欧)
Golf (JU)	高尔夫(日美)
Golf '92, The (J)	92年代高尔夫(日)
Golf Club - Birdy Rush (J)	高尔夫锦标赛(日)
Golf Grand Slam (J)	高尔夫公开赛(日)
Golf Grand Slam (U)	高尔夫公开赛(美)
Golf Ko Open (J)	高尔夫公开赛(日)
Golgo 13 - Dai 1 Shou - Kamigami no Tasogare (J)	狙击13-诸神的黄昏(日)
Golgo 13 - The Riddle of Icarus (J)	狙击13-谜之杀手(日)
Golgo 13 - Top Secret Episode (U)	狙击13-谜之二章(日)
Gomoku Narabe (J)	五子棋(日)
Goonies 2 - Fratelli Saigo no Chousen (J)	七宝奇谋2(日)
Goonies 2, The (E)	七宝奇谋2(欧)
Goonies 2, The (U)	七宝奇谋2(美)
Goonies, The (J)	七宝奇谋(日)
Gorby no Pipeline Dai Sakusen (J)	果比大作战(日)
Gorilla Man (J)	果里亚人(日)
Gotcha! (U)	陆战运动(日)
Gozonji - Yaji Kita Chin Douchuu (J)	御存知弥次喜多珍道中(日)
Gradius (E)	沙罗曼蛇(欧)
Gradius (J)	沙罗曼蛇(日)
Gradius (U)	沙罗曼蛇(美)
Gradius (ArchiMENdes Hen) (J)	沙罗曼蛇(ArchiMENdes Hen)(日)
Gradius 2 (J)	沙罗曼蛇2(日)
Grand Master (J)	救世主(日)
Great Battle Cyber (J)	高达-伟大的战斗(日)
Great Boxing - Rush Up (J)	冲刺!拳王之路(日)
Great Deal (J)	扑克方块(日)
Great Tank (J)	导弹坦克(日)
Great Waldo Search, The (U)	搜索家(美)
Greg Norman's Golf Power (U)	诺曼高尔夫(美)
Gremlin 2 - Shinshu Tanjou (J)	小魔怪2(日)
Gremlins 2 - The New Batch (E)	小魔怪2(欧)
Gremlins 2 - The New Batch (U)	小魔怪2(美)
Gryzor (J)	古莱泽(日)
Guardian Legend, The (U)	嘉迪恩传说(美)
Guerrilla War (U)	古巴英雄(美)
Guevara (J)	吉瓦拉(日)
Gumshoe (UE)	钢锈(美,欧)
Gun Hed (J)	首领之枪(日)
Gun Nac (J)	加纳战机(日)
Gun Nac (U)	加纳战机(美)
Gun Sight (J)	枪战(美)
Gun Smoke (E)	荒野大镖客(欧)
Gun Smoke (U)	荒野大镖客(美)
Gun-Dec (J)	火炮(日)
Gyrodine (J)	战斗直升机(日)
Gyromite (JUE)	战斗直升机(日,美,欧)
Gyruss (U)	太空射击战(美)
Haja no Fuuin (J)	霸邪之封印(日)
Hammerin' Harry (E)
Hana no Star Kaidou (J)	花之星街道(日)
Hanafuda Yuukyou Den - Nagarebana Oryuu (J)	花札游戏(日)
Hanjuku Hero (J)	半熟英雄(日)
Happy Birthday Bugs (J)
Harlem Globetrotters (U)	篮球赛(美)
Hatris (J)	帽子方块(日)
Hatris (U)	帽子方块(美)
Hayauchi Super Igo (J)
Heavy Barrel (J)	重级作战(重武器，重装战士)(日)
Heavy Barrel (U)	重级作战(重武器，重装战士)(美)
Heavy Shreddin' (U)	滑雪(美)
Hebereke (J)	迷糊蛋(日)
Hector 87 (J)	爆击战士'87(日)
Heisei Tensai Bakabon (J)	平成天才学校(日)
Hello Kitty no Ohanabatake (J)	凯蒂猫冒险(Q版冒险)(日)
Hello Kitty World (J)	凯蒂猫气球世界(Q版气球世界)(日)
Herakles no Eikou - Toujin Makyou Den (J)
Herakles no Eikou 2 - Titan no Metsubou (J)
Hero Quest (Prototype) (U)	英雄探险(工程版)(美)
HES 6-in-1 (U)
Hi no Tori - Houou Hen - Gaou no Bouken (J)	火之鸟凤凰篇-我王之冒险(日)
Higemaru Makaijima - Nanatsu no Shima Dai Bouken (J)
High Speed (U)	高速赛车(美)
Highway Star (J)	高速公路赛车(高速之星)(日)
Hirake! Ponkikki (J)	潘克(日)
Hiryuu no Ken - Ougi no Sho (J)	飞龙之拳(日)
Hiryuu no Ken 2 - Dragon no Tsubasa (J)	飞龙之拳2(日)
Hiryuu no Ken 3 - 5 Nin no Ryuu Senshi (J)	飞龙之拳3(日)
Hiryuu no Ken Special - Fighting Wars (J)	飞龙之拳特别篇(日)
Hissatsu Doujou Yaburi (J)	必杀道场破(日)
Hissatsu Shigoto Nin (J)	必杀仕事人(日)
Hitler no Fukkatsu - Top Secret (J)	希特勒复活(希魔复活，暗杀希特勒)(日)
Hogan's Alley (JU)	警技射击(日,美)
Hokuto no Ken (J)	北斗之拳(日)
Hokuto no Ken 2 - Seikimatsu Kyuuseishu Densetsu (J)	北斗之拳2(日)
Hokuto no Ken 3 - Shin Seiki Souzou Seiken Restuden (J)	北斗之拳3(日)
Hokuto no Ken 4 - Shichisei Haken Den - Hokuto Shinken no Kanata he (J)	北斗之拳4(日)
Hollywood Squares (U)	好莱坞广场(美)
Holy Diver (J)	神圣救世主(日)
Home Alone (U)
Home Alone 2 - Lost in New York (U)
Home Run Nighter - Pennant League!! (J)
Home Run Nighter '90 - The Pennant League (J)
Honoo no Toukyuuji - Dodge Danpei (J)	炎之斗球儿-躲避球弹平(日)
Honoo no Toukyuuji - Dodge Danpei 2 (J)	炎之斗球儿-躲避球弹平2(日)
Hook (E)	铁钩船长(欧)
Hook (J)	铁钩船长(日)
Hook (U)	铁钩船长(美
Hoops (U)	街头篮球(美)
Hoshi no Kirby - Yume no Izumi no Monogatari (J)	星之卡比(星之泉精灵物语)(日)
Hoshi wo Miru Hito (J)
Hostages - The Embassy Mission (J)
Hot Slot (UE)
Hototogisu (J)	不如归(日)
Hottaaman no Chitei Tanken (J)	地底探险(日)
Houma ga Toki (J)	仿魔之刻(日)
Huang Di (C)	黄帝(中)
Hudson Hawk (J)	哈德森之鹰(日)
Hudson Hawk (U)	哈德森之鹰(美)
Hudson's Adventure Island (U)	高桥名人的冒险岛(美)
Hudson's Adventure Island 2 (E)	高桥名人的冒险岛2(欧)
Hudson's Adventure Island 2 (U)	高桥名人的冒险岛2(美)
Hudson's Adventure Island 3 (U)	高桥名人的冒险岛3(美)
Hunt for Red October, The (E)	追击赤色十月(欧)
Hunt for Red October, The (U)	追击赤色十月(美)
Hyakkiyakou (J)	百鬼夜行(日)
Hyaku no Sekai no Monogatari - The Tales on a Watery Wilderness (J)
Hyaku no Sekai no Monogatari - The Tales on a Watery Wilderness [a1] (J)
Hyaku no Sekai no Monogatari - The Tales on a Watery Wilderness [a2] (J)
Hyaku no Sekai no Monogatari - The Tales on a Watery Wilderness [a3] (J)
Hydlide (U)	梦幻仙境(美)
Hydlide 3 - Yami Kara no Houmonsha (J)	梦幻仙境3 (日)
Hydlide Special (J)	梦幻仙境HYDLIDE特別篇 (日)
Hyokkori Hyoutan Jima - Nazo no Kaizokusen (J)	神秘岛(日)
Hyper Olympic (J)	超级奥林匹克美版(日)
Hyper Olympic (Gentei Ban!) (J)
Hyper Sports (J)	超级体育竞赛(金牌运动会)(日)
I Can Remember (U)
I Love Softball (J)	我爱棒球(日)
Ice Climber (J)	敲冰块(日)
Ice Climber (U)	敲冰块(美)
Ice Hockey (U)	热血冰球(美
Ide Yousuke Meijin no Jissen Mahjong (J)
Ide Yousuke Meijin no Jissen Mahjong 2 (J)
Idol Hakkenden (J)	明星八犬传(日)
Idol Shisen Mahjang (J)
Igo - Kyuu Roban Taikyoku (J)
Igo Meikan (J)	围棋名鉴(日)
Igo Shinan (J)	围棋指南(日)
Igo Shinan '91 (J)	围棋指南'91(日)
Igo Shinan '92 (J)	围棋指南'92(日)
Igo Shinan '93 (J)	围棋指南'93(日)
Igo Shinan '94 (J)	围棋指南'94(日)
Ikari (J)	怒(日)
Ikari 2 - Dogosoken (J)	怒2(日)
Ikari 3 (J)	怒3(日)
Ikari 3 - The Rescue (U)	怒3(美)
Ikari Warriors (E)
Ikari Warriors (PRG 1) (U)
Ikari Warriors (U)
Ikari Warriors 2 - Victory Road (U)
Ike Ike! Nekketsu Hockey Bu - Subette Koronde Dai Rantou (J)
Ikinari Musician (J)	一丽音乐会(日)
Ikki (J)	忍者大决战(日)
Image Fight (J)	梦幻战机IMAGE FIGHT(日)
Image Fight (U)	梦幻战机IMAGE FIGHT(美)
Immortal, The (U)	不死传说(美)
Impossible Mission 2 (U)	不可能任务2(日)
Incredible Crash Dummies, The (U)	实验人冒险(美)
Indiana Jones and the Last Crusade (Taito) (U)	印地安那琼斯(Taito版)(美)
Indiana Jones and the Last Crusade (UBI Soft) (U)	印地安那琼斯(UBI Soft版)(美)
Indiana Jones and the Temple of Doom (U)	印地安那琼斯-毁灭之庙(美)
Indiana Jones and the Temple of Doom (Tengen) (U)
Indora no Hikari (J)
Infiltrator (U)	渗透者飞机(美)
Insector X (J)	杀虫战记X(日)
International Cricket (E)
International Cricket (Prototype) (E)
Iron Tank (U)
Ironsword - Wizards & Warriors 2 (E)	巫士与战士2-铁剑(欧)
Ironsword - Wizards & Warriors 2 (U)	巫士与战士2-铁剑(美)
Isaki Shuugorou no Keiba Hisshou Gaku (J)
Ishin no Arashi (J)
Isolated Warrior (E)
Isolated Warrior (U)
Itadaki Street - Watashi no Mise ni Yottette (J)	赌博街(日)
Ivan Ironman Stewart's Super Offroad (U)
J League Fighting Soccer - The King of Ace Strikers (J)	J联盟战斗足球(日)
J League Winning Goal (J)	J联盟胜利足球(日)
Jack Nicklaus' Greatest 18 Holes of Champ. Golf (E)
Jack Nicklaus' Greatest 18 Holes of Champ. Golf (U)
Jackal (U)	赤色要塞(美)
Jackie Chan (J)	成龙(日)
Jackie Chan's Action Kung Fu (E)
Jackie Chan's Action Kung Fu (U)
Jajamaru Gekimaden - Maboroshi no Kinmajou (J)	茶茶丸之击魔传(日)
Jajamaru Ninpou Chou (J)
Jajamaru no Dai Bouken (J)
James Bond Jr (E)
James Bond Jr (U)
Jangou (J)	雀豪(日)
Jarinko Chie - Bakudan Musume no Shiawase Sagashi (J)	搬运工(日)
Jaws (U)	钓大白鲨(日)
Jeopardy! (U)
Jeopardy! 25th Anniversary Edition (U)
Jeopardy! Junior Edition (U)
Jesus - Kyoufu no Bio Monster (J)
Jetsons - Cogswell's Caper!, The (J)
Jetsons - Cogswell's Caper!, The (U)
Ji Jia Zhan Shi (C)	机甲战士(中)
Jigoku Gokuraku Maru (J)	地狱极乐丸(日)
Jikuu Yuuden - Debias (J)	时空勇传(日)
Jimmy Connor's Tennis (E)	网球(欧)
Jimmy Connor's Tennis (U)	网球(美)
Jing Ke Xin Zhuan (C)	荆轲新传(中)
JJ - Tobidase Daisakusen Part 2 (J)
Joe & Mac (U)
John Elway's Quarterback (U)	美式足球(美)
Jongbou (J)	弹珠麻将(日)
Jordan Vs Bird - One On One (U)	乔丹VS伯德(美)
Joshua (Ver 5.0) (U)
Joshua (Ver 6.0) (U)
Journey to Silius (U)
Joust (J)
Joust (U)
Joy Mecha Fight (J)
Joypad Test Cartridge (U)
Juju Densetsu (J)	传说(日)
Jumbo Ozaki no Hole in One Professional (J)
Jumpin' Kid - Jack to Mame no Ki Monogatari (J)
Jungle Book, The (E)	小泰山(欧)
Jungle Book, The (U)	小泰山(美)
Jurassic Park (U)	侏罗纪公园(美)
Just Breed (J)
Juuouki (J)	兽王记(日)
Juuryoku Soukou Metal Storm (J)
Juvei Quest (J)
Kabuki - Quantum Fighter (E)
Kabuki - Quantum Fighter (U)
Kabushiki Doujou (J)	株式道场(日)
Kaettekita! Gunjin Shougi - Nanya Sore! (J)	军人将棋(军棋)(日)
Kage (J)	赤影战士(水上魂斗罗)(日)
Kage no Densetsu (J)	影子传说(日)
Kagerou Densetsu (J)	影狼传说(日)
Kaguya Hime Densetsu (J)	竹取公主(日)
Kaijuu Monogatari (J)	贝兽物语(日)
Kaiketsu Yanchamaru (J)	快杰洋枪(日)
Kaiketsu Yanchamaru 2 - Karakuri Land (J)	快杰洋枪2(日)
Kaiketsu Yanchamaru 3 - Taiketsu! Zouringen (J)	快杰洋枪3(日)
Kakefu Kun no Jump Tengoku - Speed Jigoku (J)	JUMP天国(加其夫天国与地狱)(日)
Kame no Ongaeshi - Urashima Densetsu (J)	义龟报恩(乌龟报恩)(日)
Kamen no Ninja - Akakage (J)	赤影(日)
Kamen no Ninja - Hanamaru (J)	假面忍者花丸(日)
Kamen Rider Kurabu (J)	假面超人俱乐部(日)
Kamen Rider SD - Guranshokkaa no Yabou (J)	假面超人SD(日)
Kanshakudama Nage Kantarou no Toukaidou Gojuusan Tsugi (J)
Karakuri Kengou Den - Musashi Road - Karakuri Nin Hashiru! (J)
Karaoke Studio (J)
Karaoke Studio Senyou Cassette Vol 1 (J)
Karaoke Studio Senyou Cassette Vol 2 (J)
Karate Champ (U)	空手道冠军(美)
Karate Kid, The (U)
Karateka (J)	英雄救美(日)
Karnov (J)	卡诺夫(日)
Karnov (U)	卡诺夫(美)
Kawa no Nushi Tsuri (J)	钓鱼冒险(钓鱼太郎)(日)
Keiba Simulation - Honmei (J)	本命赛马(日)
Kero Kero Keroppi no Dai Bouken (J)
Kero Kero Keroppi no Dai Bouken 2 - Donuts Ike ha Oosawagi! (J)
Keroppi to Keroriinu no Splash Bomb! (J)	大眼蛙方块(日)
Kick Master (U)
Kick Off (E)
Kickle Cubicle (E)
Kickle Cubicle (U)
Kid Icarus (UE)
Kid Klown (U)
Kid Kool (U)	JUMP天国美版(加其夫天国与地狱)(美)
Kid Niki - Radical Ninja (PRG 1) (U)	快杰洋枪(PRG 1)(美)
Kid Niki - Radical Ninja (U)	快杰洋枪(美)
King Kong 2 - Ikari no Megaton Punch (J)	金刚2(日)
King Neptune's Adventure (U)
King of Kings (J)	万王之王(王中王)(日)
King of Kings, The (V1.1) (U)	万王之王(王中王)(V1.1)(美)
King of Kings, The (V1.2) (U)	万王之王(王中王)(V1.2)(美)
King of Kings, The (V1.3) (U)	万王之王(王中王)(V1.3)(美)
King of Kings, The (V5.0) (U)	万王之王(王中王)(V5.0)(美)
King's Knight (J)	国王骑士(日)
King's Knight (U)	国王骑士(美)
Kings of the Beach (U)
King's Quest V (U)	国王秘史5(美)
Kinnikuman - Muscle Tag Match (J)	筋肉人摔角大赛(日)
Kirby's Adventure (E)
Kirby's Adventure (PRG 1) (U)
Kirby's Adventure (U)
Kirby's Adventure (U)
Kiteretsu Dai Hyakka (J)
Kiwi Kraze (U)	新西兰故事(美)
Klash Ball (U)
Klax (J)
Klax (U)
Knight Rider (J)
Knight Rider (U)
Konami Hyper Soccer (E)	柯那米超级足球(欧)
Konamic Sports in Seoul (J)	柯那米运动之魂(汉城奥运)(日)
Kouryuu Densetsu Villgust Gaiden (J)
Koushien (J)	棒球甲子园(甲子园)(日)
Krazy Kreatures (U)	益智游戏(美)
Krion Conquest, The (U)	魔女小红帽(美)
Krusty's Fun House (E)	Krusty的乐趣屋(欧)
Krusty's Fun House (U)	Krusty的乐趣屋(美)
Kujaku Ou (J)	孔雀王(日)
Kujaku Ou 2 (J)	孔雀王2(日)
Kung Fu (U)
Kung-Fu Heroes (U)	超级中国拳(美)
Kunio Kun no Nekketsu Soccer League (J)	热血足球2(热血联盟足球)(日)
Kurogane Hiroshi no Yosou Daisuki! - Kachiuma Densetsu (J)
Kyonshiizu 2 (J)	僵尸小子2(日)
Kyoro Chan Land (J)	格斗高塔(日)
Kyouryuu Sentai Juuranger (J)
Kyuukyoku Harikiri Koushien (J)	究极甲子园(日)
Kyuukyoku Harikiri Stadium (J)	究极棒球(日)
Kyuukyoku Harikiri Stadium - Heisei Gannen Ban (J)	究极棒球平成元年版(日)
Kyuukyoku Harikiri Stadium ('88 Senshu Shin Data) (J)	究极棒球'88(日)
Kyuukyoku Harikiri Stadium 3 (J)	究极棒球3(日)
Kyuukyoku Tiger (J)	究极虎(日)
Labyrinth (J)	迷宫(日)
Lagrange Point (J)	拉格朗治点(日)
Laser Invasion (U)	激光入侵(美)
Last Action Hero (U)	幻影英雄(美)
Last Armageddon (J)
Last Ninja, The (U)	最后的忍者(美)
Last Starfighter, The (U)	最后星际战士(美)
Law of the West (J)	西部法律(日)
Layla (J)	蕾拉/女超人蕾拉(日)
Lee Trevino's Fighting Golf (U)	战斗高尔夫(美)
Legacy of the Wizard (U)	魔道士的遗产(美)
Legend of Kage, The (U)	影子传说(美)
Legend of Prince Valiant, The (E)	英勇王子传奇(欧)
Legend of the Ghost Lion (U)	鬼魂狮子传奇(美)
Legend of Zelda, The (PRG 1) (U)	萨尔达传说(PRG 1 )(美)
Legend of Zelda, The (U)	萨尔达传说(美)
Legendary Wings (U)	传奇翼(美)
Legends of the Diamond (U)	Bandai棒球-钻石传奇(美)
Lemmings (U)
L'Empereur (J)
L'Empereur (U)
Les Chevaliers Du Zodiaque (F)
Lethal Weapon (U)	致命武器(美)
Lifeforce (E)	沙罗曼蛇(欧)
Lifeforce (U)	沙罗曼蛇(美)
Linus Spacehead's Cosmic Crusade (Aladdin) (U)
Lion King, The (E)	狮子王(欧)
Lipple Island (J)	LIPPLE岛(日)
Little League Baseball - Championship Series (U)	同盟棒球 - 冠军(美)
Little Magic (J)	超魔兽大战(日)
Little Mermaid - Ningyo Hime (J)	小美人鱼(日)
Little Mermaid, The (U)	小美人鱼(美)
Little Nemo - The Dream Master (E)
Little Nemo - The Dream Master (U)
Little Ninja Brothers (E)	超级中国拳2(欧)
Little Ninja Brothers (U)	超级中国拳2(美)
Little Samson (U)	圣灵传说 (美)
Live in Power Bowl - TM Network (J)	生活在权利碗里(日)
Lode Runner (J)	金块/淘金者(日)
Lode Runner (U)	金块/淘金者(美)
Lone Ranger, The (U)	独行侠(美)
Loopz (U)
Lord of King, The (J)	战王之王(日)
Lost Word of Jenny (J)	珍妮(日)
Lot Lot (J)
Low G Man (E)	反重力战士(欧)
Lunar Ball (J)	月宫桌球(日)
Lunar Pool (E)	月球水池(欧)
Lunar Pool (U)	月球水池(美)
Lupin Sansei - Pandora no Isan (J)	鲁邦三世(日)
M.U.L.E. (U)
M.U.S.C.L.E. (U)
M82 Game Selectable Working Product Display (E)	82合1(欧)
Mach Rider (E)	机车大赛(欧)
Mach Rider (JU)	机车大赛(日欧)
Mad City (J)	鳄鱼先生(日)
Mad Max (U)	冲锋飞车队(美)
Mafat Conspiracy - Golgo 13 (U)	玛法特的阴谋(美)
Magic Candle, The (J)	魔烛战记(日)
Magic Darts (J)	飞标大赛(日)
Magic Darts (U)	飞标大赛(美)
Magic Jewelry (C)	魔法宝石方块(中)
Magic John (J)	魔术师约翰逊(日)
Magic Johnson's Fast Break (U)	魔术师约翰逊的快攻(美)
Magic of Scheherazade, The (U)	魔女小红帽(日)
Magical Doropie (J)	魔女小红帽(日)
Magical Taruruuto Kun - Fantastic World!! (J)	小魔星达鲁鲁(日)
Magical Taruruuto Kun 2 - Mahou Dai Bouken (J)	小魔星达鲁鲁2(日)
Magician (Prototype) (U)	魔法师(工程版)(美)
Magician (U)	魔法师(美)
Magmax (J)	组合金刚(日)
Magmax (Prototype) (U)	组合金刚(工程版)(日)
Magmax (U)	组合金刚(美)
Magnum Kiki Ippatsu - Empire City - 1931 (J)	玛克纳姆危机一发(日)
Maharaja (J)	印度之旅(日)
Mahjong (J)	麻雀(日)
Mahjong Club - Nagatachou (J)	麻将俱乐部(日)
Mahjong RPG Dora Dora Dora (J)	DORA麻将RPG(日)
Mahjong Taikai (J)	麻将大会(日)
Mahjong Taisen (J)	麻将大战(日)
Mahou no Princess Minky Momo - Remember Dream (J)	魔法少女/魔法皇后(日)
Maison Ikkoku (J)	相聚一刻/一刻公寓(日)
Majaventure - Mahjong Senki (J)	麻雀战记(日)
Majin Eiyuu Den Wataru Gaiden (J)	魔神英雄传(日)
Major League (J)	职棒大联盟(日)
Major League Baseball (U)	职棒大联盟(美)
Majou Densetsu 2 - Daimashikyou Galious (J)	魔城传说2-大魔司教(日)
Makaimura (J)	魔界村(日)
Maniac Mansion (E)	疯狂豪宅(欧)
Maniac Mansion (J)	疯狂豪宅(日)
Maniac Mansion (NL)	疯狂豪宅(NL)
Maniac Mansion (U)	疯狂豪宅(美)
Mappy (J)	快乐猫(日)
Mappy Kids (J)	快乐鼠(日)
Mappy-Land (J)	快乐猫世界(日)
Mappy-Land (U)	快乐猫世界(美)
Marble Madness (E)	滚球大战(欧)
Marble Madness (U)	滚球大战(美)
Mario & Yoshi (E)
Mario Bros (JU)	马里奥兄弟(日美)
Mario is Missing! (U)	马里奥失踪！(美)
Mario Open Golf (J)	马里奥高尔夫(美)
Mario's Time Machine! (U)	马里奥时间机器(美)
Marusa no Onna (J)	MARUSA之女(日)
Marvel's X-Men (U)
Mashou (J)	魔钟(日)
Master Chu & The Drunkard Hu (U)
Masuzoe Youichi - Asa Made Famicom (J)
Matendouji (J)	魔天童子(日)
Matsumoto Tooru no Kabushiki Hisshou Gaku (J)	松本亨经营必胜学2/松本亨株式必胜学(日)
Matsumoto Tooru no Kabushiki Hisshou Gaku 2 (J)	松本亨经营必胜学2/松本亨株式必胜学2(日)
Max Warrior - Wakusei Kaigenrei (J)	孤独战士-惑星戒严令(日)
Maxi 15 (U)	15合1(美)
Maxi 15 (U)	15合1(美)
MC Kids (U)	麦当劳小子(日)
McDonaldland (E)	麦当劳(欧)
Mechanized Attack (U)	机动化突袭(美)
Mega Man (E)	洛克人(欧)
Mega Man (U)	洛克人(美)
Mega Man 2 (E)	洛克人2(欧)
Mega Man 2 (U)	洛克人2(美)
Mega Man 3 (U)	洛克人3(美)
Mega Man 3 (Prototype) (U)	洛克人3(工程版)(美)
Mega Man 4 (E)	洛克人4(欧)
Mega Man 4 (U)	洛克人4(美)
Mega Man 5 (U)	洛克人5(美)
Mega Man 6 (U)	洛克人6(美)
Mei Tantei Holmes - Kiri no London Satsujin Jiken (J)	名侦探福尔摩斯-伦敦之杀人事件(日)
Mei Tantei Holmes - M Kara no Chousenjou (J)	名侦探福尔摩斯(日)
Meiji Ishin (J)	明治维新(日)
Meikyuu Jima (J)	迷宫岛(日)
Meikyuu Kumikyoku (J)	迷宫组曲(日)
Meimon! Dai San Yakyuu Bu (J)	名门-第三野球部(日)
Meimon! Takonishi Ouendan - Kouha 6 Nin Shuu (J)	名门-多古西应援团(日)
Melville's Flame (J)	Melville的火焰(日)
Menace Beach (U)	危险海滩(美)
Mendel Palace (U)	Mendel的宫殿(美)
Mermaids of Atlantis (U)
Metal Fighter (U)	未来小子.金属格斗 (美)
Metal Fighter (Wei Lai Xiao Zi) (Joy Van) (C)	未来小子(Joy Van)(中)
Metal Flame Psybuster (J)	金属装甲(日)
Metal Gear (E)	合金装备/燃烧战车(欧)
Metal Gear (J)	合金装备/燃烧战车(日)
Metal Gear (U)	合金装备/燃烧战车(美)
Metal Max (J)	重装机兵(日)
Metal Mech (U)	机械金属(美)
Metal Slader Glory (J)	金属荣耀(日)
Metal Storm (U)	重力装甲(美)
Metro-Cross (J)	追赶跑跳蹦(日)
Metroid (E)	银河战士(欧)
Metroid (U)	银河战士(美)
Mezase Pachi Pro - Pachio Kun (J)	柏青哥君/派金宫君(日)
Mezase Top Pro - Green ni Kakeru Yume (J)	职业高尔夫球(日)
Michael Andretti's World Grand Prix (U)
Mickey Mouse (J)	米老鼠(日)
Mickey Mouse 3 - Yume Fuusen (J)	米老鼠3(日)
Mickey Mousecapade (U)
Mickey's Adventures in Numberland (U)	米老鼠数字岛大冒险(美)
Mickey's Safari in Letterland (U)	米老鼠字母岛大冒险(美)
Micro Machines (U)	微型机器(美)
Micro Machines (Aladdin) (UE)	微型机器 (Aladdin)(欧美)
Mig-29 Soviet Fighter (U)	米格29战斗机(美)
Might and Magic (J)	魔法门(日)
Might and Magic (U)	魔法门(美)
Mighty Bomb Jack (J)	炸弹人杰克(日)
Mighty Bomb Jack (U)	炸弹人杰克(美)
Mighty Final Fight (J)	SD街头快打/快打旋风(日)
Mighty Final Fight (U)	SD街头快打/快打旋风(美)
Mike Tyson's Punch-Out!! (PRG 1) (E)
Mike Tyson's Punch-Out!! (PRG 1) (U)
Mike Tyson's Punch-Out!! (E)
Mike Tyson's Punch-Out!! (U)
Millipede (J)	杀虫大战(日)
Millipede (U)	杀虫大战(美)
Milon's Secret Castle (U)	迷宫组曲(美)
Milon's Secret Castle (J)	迷宫组曲(日)
Mindseeker (J)
Minelvaton Saga (J)	世嘉战记(日)
Mini Putt (J)	迷你高尔夫(日)
Minna no Taabou no Nakayoshi Dai Sakusen (J)	友情大作战(日)
Miracle Piano Teaching System, The (U)
Miracle Ropit's Adventure in 2100 (J)	MIRACLE ROPIT冒险(日)
Mirai Senshi - Lios (J)	未来战史(日)
Mirai Shinwa Jarvas (J)	未来神话(日)
Mission Cobra (U)	眼镜蛇使命(美)
Mission Impossible (E)	不可能任务(欧)
Mission Impossible (U)	不可能任务(美)
Mississippi Satsujin Jiken (J)	南海道杀人事件(日)
Mito Koumon (J)	水户黄门(日)
Mito Koumon - Sekai Manyuu Ki (J)	水户黄门2(日)
Mitsume ga Tooru (J)	三目童子(日)
Mizushima Shinji no Dai Koushien (J)	水岛新司的大甲子园(日)
Moai Kun (J)	摩艾君(日)
Mobile Suit Z Gundam - Hot Scramble (J)	机动战士高达Z(日)
Moe Pro! - Saikyou Hen (J)	燃烧棒球-最强篇(日)
Moe Pro! '90 - Kandou Hen (J)	燃烧棒球90-感动篇(日)
Moero TwinBee - Cinnamon Hakase wo Sukue! (J)	兵蜂2(日)
Moero!! Junior Basket - Two on Two (J)	燃烧职业篮球-2对2(日)
Moero!! Juudou Warriors (J)	燃烧柔道战士(日)
Moero!! Pro Soccer (J)	燃烧职业足球(日)
Moero!! Pro Tennis (J)	燃烧职业网球(日)
Moero!! Pro Yakyuu (Black) (J)	燃烧职业棒球(黑)(日)
Moero!! Pro Yakyuu (Red) (J)	燃烧职业棒球(红)(日)
Moero!! Pro Yakyuu '88 - Kettei Ban (J)	燃烧职业棒球 88-决定版(日)
Moeru! Oniisan (J)	燃烧兄弟(日)
Momotarou Densetsu (J)	桃太郎传说(日)
Momotarou Densetsu Gaiden (J)	桃太郎传说外传(日)
Momotarou Dentetsu (J)	桃太郎电铁(日)
Money Game 2 - Kabutochou no Kiseki, The (J)	金钱游戏2(日)
Money Game, The (J)	金钱游戏(日)
Monopoly (J)	大富翁桌棋(日)
Monopoly (U)	大富翁桌棋(美)
Monster in My Pocket (E)	口袋妖怪(欧)
Monster in My Pocket (U)	口袋妖怪(美)
Monster Maker - 7 Tsu no Hihou (J)	妖怪缔造者(日)
Monster Party (U)	妖怪派(美)
Monster Truck Rally (U)	妖怪卡车集会(美)
Moon Crystal (J)	月光宝石(日)
Moon Ranger (U)	炮弹飞车(美)
Morita Kazuo no Shougi (J)	森田和太郎之将棋/森田棋(日)
Mother (J)	地球冒险(日)
Motocross Champion (J)	摩托车越野赛(日)
Motor City Patrol (U)	机械城市(美)
Mottomo Abunai Deka (J)	阿部刑警(日)
Mouryou Senki Madara (J)	鬼魅战记(日)
Mr. Gimmick (E)	Gimmick先生(欧)
Ms Pac-Man (U)	吃豆(美)
Ms Pac-Man (Namco) (U)	吃豆/南梦宫(美)
Muppet Adventure - Chaos at the Carnival (U)	Muppet大冒险-狂欢节(美)
Musashi no Bouken (J)	武藏的冒险(日)
Musashi no Ken - Tadaima Shugyou Chuu (J)	六三四之剑(日)
Mutant Virus, The (U)	突变体病毒(美)
My Life My Love - Boku no Yume - Watashi no Negai (J)	我的生命我的爱(日)
Mystery Quest (U)	探索(美)
Nagagutsu wo Haita Neko - Sekai Isshuu 80 Nichi Dai Bouken (J)	穿长靴的猫(日)
Naitou 9 Dan - Shougi Hiden (J)	本将棋内藤九段将棋秘传(日)
Nakajima Satoru - F-1 Hero (J)	中岛悟F1英雄(日)
Nakajima Satoru - F-1 Hero 2 (J)	中岛悟F1英雄(日)
Nakayoshi to Issho (J)
Namco Classic (J)	南梦宫高尔夫(日)
Namco Classic 2 (J)	南梦宫高尔夫2(日)
Namcot Mahjong 3 - Mahjong Tengoku (J)	南梦宫麻雀3(日)
Nangoku Shirei!! - Spy Vs Spy (J)	谍对谍-南国指令(日)
Nantettatte!! Baseball (J)
Napoleon Senki (J)	拿破仑战记(日)
NARC (U)	城市猎人(美)
Navy Blue (J)	大海战(日)
Nekketsu Kakutou Densetsu (J)	热血格斗传说(日)
Nekketsu Kouha - Kunio Kun (J)	热血硬派(日)
Nekketsu Koukou Dodgeball Bu (J)	热血高校躲避球(日)
Nekketsu Koukou Dodgeball Bu - Soccer Hen (J)	热血高校-足球篇(日)
Nekketsu! Street Basket - Ganbare Dunk Heroes (J)	热血篮球(日)
Nemo - Pajama Hero (J)	梦之勇士(日)
NES Open Tournament Golf (U)	高尔夫大赛(美)
NES Play Action Football (U)
NES PowerPad Test Cart (U)
NES Test Cart (Official Nintendo) (U)
New Ghostbusters 2 (E)	新鬼屋2/新恶魔克星2/新小鬼巴斯特2(欧)
New Ghostbusters 2 (J)	新鬼屋2/新恶魔克星2/新小鬼巴斯特2(日)
New York Nyankies (J)	纽约大拳猫(日)
New Zealand Story (E)	新西兰故事(欧)
NFL Football (U)	美式足球(美)
Nichibutsu Mahjong 3 - Mahjong G Men (J)	麻雀道场3(日)
Nigel Mansell's World Championship Challenge (U)
Nightmare On Elm Street, A (U)	恶梦街道(美)
Nightshade (U)	黑暗阴影(美)
Nihonichi no Mei Kantoku (J)	日本第一监督(日)
Niji no Silk Road (J)	彩虹之路(日)
Ningen Heiki - Dead Fox (J)	人间兵器(日)
Ninja Cop Saizou (J)	忍者刑警(日)
Ninja Crusaders (U)	忍者龙牙(美)
Ninja Crusaders - Ryuuga (J)	忍者龙牙(日)
Ninja Gaiden (U)	忍者龙剑传(美)
Ninja Gaiden 2 - The Dark Sword of Chaos (Prototype) (U)	忍者龙剑传2(工程版)(美)
Ninja Gaiden 2 - The Dark Sword of Chaos (U)	忍者龙剑传2(美)
Ninja Gaiden 3 - The Ancient Ship of Doom (U)	忍者龙剑传3(美)
Ninja Hattori Kun (J)	忍者哈特君/忍者哈得利(日)
Ninja Jajamaru - Ginga Dai Sakusen (J)	忍者茶茶丸-银河大作战(日)
Ninja Jajamaru Kun (J)	忍者茶茶丸(日)
Ninja Kid (U)	忍者少年(美)
Ninja Kun (J)	忍者君(日)
Ninja Kun - Ashura no Shou (J)	忍者君阿修罗之章(日)
Ninja Ryukenden (J)	忍者龙剑传(日)
Ninja Ryukenden 2 - Ankoku no Jashin Ken (J)	忍者龙剑传2(日)
Ninja Ryukenden 3 - Yomi no Hakobune (J)	忍者龙剑传3(日)
Ninjara Hoi! (J)	忍者勇士(日)
Nintendo World Championships 1990 (U)	任天堂世界冠军1990(美)
Nintendo World Cup (E)	任天堂世界杯(欧)
Nintendo World Cup (REV 3) (E)	任天堂世界杯(REV 3)(欧)
Nintendo World Cup (U)	任天堂世界杯(美)
Nishimura Kyoutarou Mystery - Blue Train Satsujin Jiken (J)	西村京太郎-杀人事件(日)
Nishimura Kyoutarou Mystery - Super Express Satsujin Jiken (J)	西村京太郎-杀人事件2(日)
Noah's Ark (E)	诺亚方舟(欧)
Nobunaga no Yabou - Bushou Fuuun Roku (J)	信长野望-武将风云录(日)
Nobunaga no Yabou - Sengoku Gunyuu Den (J)	信长野望-战国群雄传(日)
Nobunaga no Yabou - Zenkoku Ban (J)	信长野望-全国版(日)
Nobunaga's Ambition (U)	信长之野望(美)
Nobunaga's Ambition 2 (U)	信长之野望2(美)
North & South (J)	南北战争(日)
North & South (U)	南北战争(美)
Nuts & Milk (J)	牛奶与花生(日)
Obake no Q Tarou - Wanwan Panic (J)	Q太郎(日)
Obocchama Kun (J)
Oeka Kids - Anpanman no Hiragana Daisuki (J)	面包超人绘图2(日)
Oeka Kids - Anpanman to Oekaki Shiyou!! (J)	面包超人绘图(日)
Oishinbo (J)	美味冒险(日)
Okhotsk ni Kiyu - Hokkaidou Rensa Satsujin (J)	北海道连锁杀人事件(日)
Olympus no Tatakai (J)	奧林匹斯之战(日)
Onyanko Town (J)	猫咪小镇(日)
Operation Secret Storm (U)	秘密風暴(美)
Operation Wolf (J)	野狼突击队(日)
Operation Wolf (U)	野狼突击队(美)
Orb 3D (U)	3D球(美)
Osomatsu Kun (J)
Otaku no Seiza - An Adventure in the Otaku Galaxy (J)	远方的星座(日)
Othello (U)	奥赛罗棋(五子棋)(美)
Outlanders (J)	远离星球(日)
Over Horizon (E)	超越地平线(欧)
Over Horizon (J)	超越地平线(日)
Overlord (U)	霸王(美)
Paaman - Enban wo Torikaese!! (J)	小超人(日)
Paaman Part 2 - Himitsu Kessha Madoodan wo Taose! (J)	小超人2(日)
Pachi Com (J)	柏青哥(日)
Pachi Slot Adventure 2 - Sorotta Kun no Pachi Slot Tanteidan (J)	柏青哥冒险2(日)
Pachi Slot Adventure 3 - Bitaoshii 7 Kenzan! (J)	柏青哥冒险3(日)
Pachinko Dai Sakusen (J)	柏青哥大作战(日)
Pachinko Dai Sakusen 2 (J)	柏青哥大作战2(日)
Pachio Kun 2 (J)	柏青哥2(日)
Pachio Kun 3 (J)	柏青哥3(日)
Pachio Kun 4 (J)	柏青哥4(日)
Pachio Kun 5 (J)	柏青哥5(日)
Pac-Land (J)	小精灵世界(日)
Pac-Man (U)	小精灵(美)
Pac-Man (J)	小精灵(日)
Pac-Man (Namco) (U)	小精灵(Namco)(美)
Pac-Man (Namco) (E)	小精灵(Namco)(欧)
Pac-Man (Tengen) (U)	小精灵(Tengen)(美)
Pacmania (U)	小精灵之鬼屋魔影(美)
Palamedes (J)	方块(日)
Palamedes (U)	方块(美)
Palamedes 2 - Star Twinkles (J)	方块2(日)
Panic Restaurant (U)	超级厨师(天才厨师)(美)
Paperboy (J)	送报童(日)
Paperboy (U)	送报童(美)
Paperboy 2 (U)	送报童2(美)
Parallel World (J)	世界(日)
Parasol Henbee (J)
Parasol Stars - The Story of Bubble Bobble 3 (E)	Parasol 之星(欧)
Paris-Dakar Rally Special (J)	巴黎--达卡尔汽车拉力赛(日)
Parodius (E)	Q版沙罗曼蛇(欧)
Parodius da! (J)
Peek-A-Boo Poker (UE)	打砖块(美,欧)
Peepar Time (J)
Penguin Kun Wars (J)	投球大赛(日)
Perfect Bowling (J)	完美保龄球(日)
Perfect Fit (U)	完美配合(美)
Pesterminator (U)
Peter Pan & The Pirates (U)	小飞侠彼得潘(美)
Phantom Fighter (U)	F4鬼怪战机 (美)
Pictionary (U)	看图猜字(美)
Pinball (E)	弹珠台(欧)
Pinball (JU)	弹珠台(日,美)
Pinball Quest (J)	弹珠台(日)
Pinball Quest (U)	弹珠台(美)
Pinbot (E)	弹珠台高手(欧)
Pinbot (U)	弹珠台高手(美)
Pipe Dream (U)	白日梦(美)
Pirates! (U)	海盗(美)
Pizza Pop! (J)	流行批萨(日)
Plasma Ball (J)	等离子球(日)
Platoon (PRG 1) (U)	杀戮战场(PRG 1)(美)
Platoon (U)	杀戮战场 (美)
Pocket Zaurus - Juu Ouken no Nazo (J)	王者剑之谜(日)
Pooyan (J)	三只小猪(日)
Popeye (PRG 1) (JU)	大力水手(PRG 1)(日,美)
Popeye (JU)	大力水手(日,美)
Popeye no Eigo Asobi (J)	大力水手学英语(日)
Port Test Cartridge (U)
Portopia Renzoku Satsujin Jiken (J)
POW - Prisoners of War (U)	冷战(美)
Power Blade (U)	能量之刃(美)
Power Blade 2 (U)	能量之刃2(美)
Power Blazer (J)	能量夹克(日)
Power Punch 2 (U)
Power Soccer (J)	能量足球(日)
P'radikus Conflict (U)
Predator (J)	铁血战士(日)
Predator (U)	铁血战士(美)
President no Sentaku (J)	永远的铁血战士(日)
Prince of Persia (U)	波斯王子(美)
Princess Tomato in Salad Kingdom (U)	沙拉王国蕃茄公主(美)
Pro Action Replay (E)	金手指 Pro版(欧)
Pro Action Replay (Rev B) (U)	金手指 Pro版(美)
Pro Sport Hockey (U)	冰球 PRO(美)
Pro Wrestling (U)	职业摔跤 PRO版(美)
Pro Yakyuu - Family Stadium (J)	职业棒球(日)
Pro Yakyuu - Family Stadium '87 (J)	职业棒球 87(日)
Pro Yakyuu - Family Stadium '88 (J)	职业棒球 88(日)
Pro Yakyuu Satsujin Jiken! (J)	职业棒球杀人事件(日)
Probotector (E)	魂斗罗(欧)
Probotector 2 - Return of the Evil Forces (E)	魂斗罗2-邪恶力量的回归(欧)
Project Q (J)
Punch-Out!! (E)	逃生(欧)
Punch-Out!! (J)	逃生(日)
Punch-Out!! (U)	逃生(美)
Punisher, The (U)	惩罚者(美)
Puss 'n Boots - Pero's Great Adventure (U)	长靴猫(美)
Puyo Puyo (J)	魔法气泡(日)
Puzslot (J)	角子方块(日)
Puzzle (U)	迷题(美)
Puzznic (J)
Puzznic (U)
Pyokotan no Dai Meiro (J)	小兔大迷路(日)
Pyramid (Sachen) (U)	金字塔 (Sachen)(美)
Pyramid (Sachen-Hacker) (U)	金字塔(Sachen-Hacker)(美)
Q-bert (U)
Qix (U)
Quarter Back Scramble (J)	疯狂美式足球(日)
Quarth (J)	射击方块(日)
Quattro Adventure (U)	动作4合1(美)
Quattro Adventure (Aladdin) (U)	动作4合1(Aladdin)(美)
Quattro Arcade (U)	街机4合1(美)
Quattro Sports (U)	体育4合1(美)
Quattro Sports (Aladdin) (U)
Quattro Sports (V3 Plug-Thru Cart) (U)
Quest of Ki, The (J)	KI勇者(日)
Quinty (J)
Race America (U)	美国赛车(美)
Racer Mini Yonku - Japan Cup (J)	迷你四驱车(日)
Racket Attack (U)	网球之星(美)
Rackets & Rivals (E)	网球联赛(欧)
Rad Racer (E)	RAD赛车(欧)
Rad Racer (U)	RAD赛车(美)
Rad Racer 2 (U)	RAD赛车2(美)
Rad Racket - Deluxe Tennis 2 (U)	豪华网球2(美)
Radia Senki - Reimei Hen (J)	拉迪亚战记(日)
Raf World (J)	Raf世界/星际魂斗罗(日)
Raid 2020 (U)	RAID 2020(美)
Raid on Bungeling Bay (J)	救难直升机(日)
Raid on Bungeling Bay (U)	救难直升机(美)
Rainbow Islands - The Story of Bubble Bobble 2 (E)	彩虹岛/彩虹魔法(欧)
Rainbow Islands - The Story of Bubble Bobble 2 (J)	彩虹岛/彩虹魔法(日)
Rainbow Islands - The Story of Bubble Bobble 2 (U)	彩虹岛/彩虹魔法(美)
Rally Bike (U)	拉力摩托车
Rambo (J)	兰博/蓝波，第一滴血(日)
Rambo (U)	兰博/蓝波，第一滴血(美)
Rampage (U)	大猩猩拆楼(美)
Rampart (J)	领土之战/领国战役(日)
Rampart (U)	领土之战/领国战役(美)
Rasaaru Ishii no Childs Quest (J)	孩子的冒险(日)
RBI Baseball (U)	RBI棒球(美)
RBI Baseball 2 (U)	RBI棒球2(美)
RBI Baseball 3 (U)	RBI棒球3(美)
RC Pro-Am (PRG 1) (E)
RC Pro-Am (E)
RC Pro-Am (U)
RC Pro-Am 2 (U)
Red Ariimaa 2 (J)	魔界村外传-红魔冒险2(日)
Reigen Doushi (J)	灵幻道士(日)
Remote Control (U)
Ren & Stimpy Show, The (U)
Renegade (U)
Rescue - The Embassy Mission (E)
Rescue - The Embassy Mission (U)
Ring King (U)
River City Ransom (U)
Road Fighter (E)	马路英雄/火箭车(欧)
Road Fighter (J)	马路英雄/火箭车(日)
Road Runner (U)
RoadBlasters (U)	公路赛车(美)
Robin Hood - Prince of Thieves (U)
Robo Warrior (U)	炸弹之王(美)
Robocco Wars (J)	机器人大战(日)
Robocop (E)	机械战警(欧)
Robocop (J)	机械战警(日)
Robocop (U)	机械战警(美)
Robocop 2 (J)	机械战警2(日)
Robocop 2 (U)	机械战警2(美)
Robocop 3 (U)	机械战警3(美)
Robocop Vs The Terminator (Prototype) (U)	机械战警对魔鬼终结者(工程版)(美)
Robodemons (U)	机器人恶魔(美)
Rock 'n' Ball (U)	摇滚弹珠台(美)
Rocket Ranger (U)
Rocketeer, The (U)
Rockin' Kats (U)
Rockman (J)	洛克人(日)
Rockman 2 - Dr Wily no Nazo (J)	洛克人2(日)
Rockman 3 - Dr Wily no Saigo! (J)	洛克人3(日)
Rockman 4 - Aratanaru Yabou!! (J)	洛克人4(日)
Rockman 5 - Blues no Wana! (J)	洛克人5(日)
Rockman 6 - Shijou Saidai no Tatakai!! (J)	洛克人6(日)
Rod Land (E)	妖精物语(欧)
Rod Land (J)	妖精物语(日)
Roger Clemens MVP Baseball (U)	MVP棒球(美)
Rokudenashi Blues (J)	铁拳对钢拳/铁拳之道(日)
Rollerball (J)	弹珠台(日)
Rollerball (U)	弹珠台(美)
Rollerblade Racer (U)	汗冰赛(美)
Rollergames (U)	DJ-Boy(美)
Rolling Thunder (J)	闪电小组(日)
Rolling Thunder (U)	闪电小组(美)
Romance of the Three Kingdoms (U)	光荣三国志(美)
Romance of the Three Kingdoms 2 (U)	光荣三国志 2(美)
Romancia (J)	爱的罗曼史(日)
Roundball - 2-on-2 Challenge (U)	双人篮球(美)
Route-16 Turbo (J)	公路追击16 TURBO(日)
Royal Blood (J)	皇室血裔(日)
RPG Jinsei Game (J)	RPG人生游戏(日)
Rush'n Attack (E)	绿色兵团(欧)
Rush'n Attack (U)	绿色兵团(美)
Rygar (E)	未来战士(欧)
Rygar (U)	未来战士(美)
Saint Seiya - Ougon Densetsu (J)	圣斗士星矢(日)
Saint Seiya - Ougon Densetsu Kanketsu Hen (J)	圣斗士星矢2(日)
Saiyuuki World (J)	西游记(日)
Saiyuuki World 2 - Tenjoukai no Majin (J)	西游记2(日)
Sakigake!! Otoko Juku - Shippuu Ichi Gou Sei (J)	魁!男塾(日)
Salad no Kuni no Tomato Hime (J)	番茄公主(日)
Salamander (J)	沙罗曼蛇(日)
San Guo Zhi (C)	三国志(中文)
San Guo Zhi - Qun Xiong Zheng Ba (C)	三国志-群雄争霸(中文)
San Shi Liu Ji (C)	三十六记(中)
Sanada Juu Yuushi (J)	真田十勇士(日)
Sangokushi (J)	三国志(日)
Sangokushi - Chuugen no Hasha (J)	三国志-中原之霸者(日)
Sangokushi 2 (J)	三国志2(日)
Sangokushi 2 - Haou no Tairiku (J)	三国志2-霸王的大陆(日)
Sanma no Mei Tantei (J)	名侦探山马(日)
Sanrio Carnival (J)	凯蒂猫方块(日)
Sanrio Carnival 2 (J)	凯蒂猫方块2(日)
Sanrio Cup - Pon Pon Volley (J)	Q版排球/动物杯排球赛(日)
Sansaara Naaga (J)	育龙战记(日)
Sansuu 1 Nen - Keisan Game (J)	数学1年级(日)
Sansuu 2 Nen - Keisan Game (J)	数学2年级(日)
Sansuu 3 Nen - Keisan Game (J)	数学3年级(日)
Sansuu 4 Nen - Keisan Game (J)	数学4年级(日)
Sansuu 5 & 6 Nen - Keisan Game (J)	数学5&6年级(日)
Satomi Hakkenden (J)	里见八犬传(日)
Satsui no Kaisou - Power Soft Satsujin Jiken (J)	杀意的阶层(日)
Satsujin Club (J)
SCAT - Special Cybernetic Attack Team (U)	最终任务/空中魂斗罗(美)
SD Battle Oozumou - Heisei Hero Basho (J)	SD大相扑(日)
SD Gundam - Gachapon Senshi 2 - Capsule Senki (J)	SD高达2(日)
SD Gundam - Gachapon Senshi 3 - Eiyuu Senki (J)	SD高达3(日)
SD Gundam - Gachapon Senshi 4 - New Type Story (J)	SD高达4(日)
SD Gundam - Gachapon Senshi 5 - Battle of Universal Century (J)	SD高达5(日)
SD Gundam Gaiden - Knight Gundam Monogatari (J)	SD高达外传-骑士物语(日)
SD Gundam Gaiden - Knight Gundam Monogatari 2 - Hikari no Kishi (J)	SD高达外传-骑士物语2(日)
SD Gundam Gaiden - Knight Gundam Monogatari 3 - Densetsu no Kishi Dan (J)	SD高达外传-骑士物语3(日)
SD Hero Soukessen - Taose! Aku no Gundan (J)	SD英雄总决战(日)
SD Keiji - Blader (J)	SD刑事(日)
SD Sengoku Bushou Retsuden (J)	SD战国武将烈传(日)
Secret Scout (U)	秘密侦察兵(美)
Section Z (U)	绝对合体(美)
Seicross (J)	霹雳机车(日)
Seicross (U)	霹雳机车(美)
Seikima II - Akuma no Gyakushuu (J)	圣饥魔2(日)
Seirei Densetsu Lickle (J)	圣铃传说(日)
Seirei Gari (J)	星灵猎人/圣灵狩猎(日)
Seiryaku Simulation - Inbou no Wakusei - Shancara (J)
Sekiryuuou (J)	赤龙王(日)
Senjou no Ookami (J)
Sensha Senryaku - Sabaku no Kitsune (J)	沙漠之狐(日)
Sesame Street 123 (U)	芝麻街-学123(美)
Sesame Street ABC (U)	芝麻街-学ABC(美)
Sesame Street ABC - 123 (U)	芝麻街-学ABC-123(美)
Sesame Street Countdown (U)	芝麻街-学倒数(美)
Shadow Brain (J)	喷射头脑(日)
Shadow of the Ninja (U)	赤影战士(美)
Shadow Warriors (E)	忍者龙剑传(欧)
Shadow Warriors 2 (E)	忍者龙剑传2(欧)
Shadowgate (E)	暗影之门(欧)
Shadowgate (J)	暗影之门(日)
Shadowgate (U)	暗影之门(美)
Shadowgate (F)	暗影之门(法)
Shadowgate (NL)	暗影之门(NL)
Shaffle Fight (J)
Shanghai (J)	上海(日)
Shanghai 2 (J)	上海2(日)
Shatterhand (E)	特求指令(欧)
Shatterhand (U)	特求指令(美)
Sheng Hen Pao (Twin Loud Cannon) (C)	双响炮(中)
Sheng Huo Lie Zhuan (C)	圣火列传(中)
Sherlock Holmes - Hakushaku Reijou Yuukai Jiken (J)	歇洛克·福尔摩斯-伯爵千金诱拐事件(日)
Shi Kin Jou (J)
Shin 4 Nin Uchi Mahjong - Yakuman Tengoku (J)	役满天国(日)
Shin Jinrui - The New Type (J)	新人类(日)
Shin Moero!! Pro Yakyuu (J)	新燃烧职业棒球(日)
Shin Satomi Hakken-Den - Hikari to Yami no Tatakai (J)
Shingen The Ruler (U)
Shinobi (U)
Shinsenden (J)
Shockwave (U)	冲击波(美)
Shooting Range (U)	射击范围(美)
Short Order - Eggsplode (U)
Shougi Meikan '92 (J)	将棋名鉴'92 (日)
Shougi Meikan '93 (J)	将棋名鉴'93 (日)
Shougun (J)	将军(日)
Shoukoushi Ceddie (J)	小公子赛蒂(日)
Shounen Ashibe - Nepal Dai Bouken no Maki (J)	少年西贝大冒险(日)
Shufflepuck Cafe (J)
Shui Hu Zhuan (C)	水浒传(中)
Side Pocket (J)	花式撞球(日)
Side Pocket (U)	花式撞球(美)
Silent Assault (U)	沉默袭击(美)
Silent Service (E)	沉默舰队(欧)
Silent Service (U)	沉默舰队(美)
Silk Worm (U)	中东战争/联合大作战(美)
Silva Saga (J)	银白色沙加(日)
Silver Surfer (U)	水银人(美)
Simpsons - Bart Vs the Space Mutants, The (E)
Simpsons - Bart Vs the Space Mutants, The (U)
Simpsons - Bart Vs the World, The (U)
Simpsons - Bartman Meets Radioactive Man, The (U)
Skate or Die 2 - The Search for Double Trouble (U)	滑冰2(美)
Skate or Die! (E)	滑冰(欧)
Skate or Die! (U)	滑冰(美)
Ski or Die (U)	滑雪(美)
Skull & Crossbones (U)
Sky Destroyer (J)	红巾特攻队(日)
Sky Kid (J)	天堂鸟(日)
Sky Kid (U)	天堂鸟(美)
Sky Shark (U)
Slalom (E)	滑雪(欧)
Slalom (U)	滑雪(美)
Smash TV (E)	大混战(欧)
Smash TV (U)	大混战(美)
Smurfs, The (E)
Snake Rattle'n Roll (E)	双蛇城/响尾蛇，贪吃蛇(欧)
Snake Rattle'n Roll (U)	双蛇城/响尾蛇，贪吃蛇(美)
Snake's Revenge (E)
Snake's Revenge (U)
Snoopy's Silly Sports Spectacular (U)
Snow Bros (J)	雪山兄弟(日)
Snow Bros (U)	雪山兄弟(美)
Soap Panic (J)
Soccer (E)	足球(欧)
Soccer (JU)	足球(日欧)
Soccer League - Winner's Cup (J)	维那斯杯足球赛(日)
Softball Tengoku (J)	动物棒球天国(日)
Solar Jetman - Hunt for the Golden Warpship (E)
Solar Jetman - Hunt for the Golden Warpship (U)
Solitaire (U)	独粒宝石/黑杰克(美)
Solomon no Kagi (J)	所罗门之匙(日)
Solomon no Kagi 2 - Coolmin Tou Kyuushutsu Sakusen (J)	所罗门之匙2(日)
Solomon's Key (E)	所罗门之匙(欧)
Solomon's Key (U)	所罗门之匙(美)
Solstice (E)	魔法师大战(欧)
Solstice (J)	魔法师大战(日)
Solstice (U)	魔法师大战(美)
Son Son (J)	孙孙(日)
Sore Ike! Anpanman - Minna de Hiking Game! (J)
Space Harrier (J)	时空战士(日)
Space Hunter (J)	太空女超人(日)
Space Invaders (J)	太空侵略者/星际保卫战(日)
Space Shadow (J)	影之空间(日)
Space Shuttle Project (U)	太空穿梭机计划(美)
Spartan X (J)	成龙踢馆(日)
Spartan X 2 (J)	成龙踢馆2(日)
Spelunker (U)	地下冒险(美)
Spelunker (J)	地下冒险(日)
Spelunker 2 - Yuusha heno Chousen (J)	地下冒险2(日)
Spider-Man - Return of the Sinister Six (U)
Spiritual Warfare (Ver 6.0) (U)	精神战争(6.0)(美)
Spiritual Warfare (Ver 6.1) (U)	精神战争(6.1)(美)
Splatter House - Wanpaku Graffiti (J)	鬼屋冒险(日)
Spot (J)	点子精灵(日)
Spot (U)	点子精灵(美)
Spy Hunter (U)	间谍猎人(美)
Spy Vs Spy (E)	间谍大战/谍对谍(欧)
Spy Vs Spy (J)	间谍大战/谍对谍(日)
Spy Vs Spy (U)	间谍大战/谍对谍(美)
Sqoon (U)	潜水艇大作战(美)
Sqoon (J)	潜水艇大作战(日)
Square no Tom Sawyer (J)	汤姆索亚历险记(日)
Stack-Up (JU)	机器人方块(日)
Stadium Events (U)
Stanley - The Search for Dr Livingston (U)
Star Force (U)	星际战机/星际争霸战(美)
Star Force (J)	星际战机/星际争霸战(日)
Star Gate (J)	星际之门/星空之门(日)
Star Luster (J)	星空战机/太空立体战(日)
Star Soldier (J)	星际战士(日)
Star Soldier (U)	星际战士(美)
Star Trek - 25th Anniversary (U)
Star Trek - The Next Generation (U)
Star Voyager (U)
Star Wars (E)	星球大战(欧)
Star Wars (U)	星球大战(美)
Star Wars - The Empire Strikes Back (J)	星球大战(日)
Star Wars - The Empire Strikes Back (U)	星球大战(美)
Star Wars (Namco) (J)	星球大战(NAMCO版)(日)
Star Wars (Victor Ongaku Sangyou) (J)	星球大战(VICTOR版)(日)
Starship Hector (U)
Startropics (U)
Startropics 2 - Zoda's Revenge (U)
Stealth ATF (E)
Stealth ATF (U)
Sted - Iseki Wakusei no Yabou (J)	STED-惑星之野望(日)
Stick Hunter - Exciting Ice Hockey (J)
Stinger (U)	兵蜂2(美)
Street Cop (U)	街头警察(美)
Street Fighter 2010 (J)	街头战士2010(日)
Street Fighter 2010 (U)	街头战士2010(美)
Street Gangs (E)
Strider (U)	出击飞龙(美)
Stunt Kids (U)	特技小子(美)
Sugoro Quest - Dice no Senshi Tachi (J)	赌神(日)
Suikoden - Tenmei no Chikai (J)	水浒传-天命之誓(日)
Sukeban Deka 3 (J)	刑事三姐妹/女警3(日)
Summer Carnival '92 - Recca (J)	烈火'92(日)
Sunday Funday (U)	娱乐3合1
Super Arabian (J)	辛巴达/超级阿拉伯大冒险(日)
Super Black Onyx (J)	超级黑色魔境(日)
Super C (U)	魂斗罗2(美)
Super Cars (U)	超级赛车(美)
Super Chinese (J)	超级中国拳/超级中国人(日)
Super Chinese 2 - Dragon Kid (J)	超级中国拳2/超级中国人2(日)
Super Chinese 3 (J)	超级中国拳3/超级中国人3(日)
Super Dodge Ball (U)
Super Donkey Kong - Xiang Jiao Chuan (C)	超级大金刚-香蕉船(中)
Super Dyna'mix Badminton (J)	超级羽毛球(日)
Super Glove Ball (U)	超级手球(美)
Super Gryzor (J)	魂斗罗2(日)
Super Jeopardy! (U)	超级危险(美)
Super Mario Bros (E)	超级马里奥(欧)
Super Mario Bros (PRG 1) (JU)	超级马里奥(日)
Super Mario Bros - Duck Hunt (E)	超级马里奥(欧)
Super Mario Bros - Duck Hunt (U)	超级马里奥(美)
Super Mario Bros - Duck Hunt - Track Meet (U)	超级马里奥(美)
Super Mario Bros (JU)	超级马里奥(日欧)
Super Mario Bros 2 (E)	超级马里奥2(欧)
Super Mario Bros 2 (PRG 1) (U)	超级马里奥2(美)
Super Mario Bros 2 (U)	超级马里奥2(美)
Super Mario Bros 3 (E)	超级马里奥3(欧)
Super Mario Bros 3 (J)	超级马里奥3(日)
Super Mario Bros 3 (PRG 1) (U)	超级马里奥3(美)
Super Mario Bros 3 (U)	超级马里奥3(美)
Super Mario USA (J)	超级马里奥USA(日)
Super Mogura Tataki!! - Pokkun Moguraa (J)	打地鼠(日)
Super Momotarou Dentetsu (J)	超级桃太郎电铁(日)
Super Off-Road (E)
Super Pinball (J)	超级弹珠台(日)
Super Pitfall (J)	超级弹珠台(日)
Super Pitfall (U)	超级弹珠台(美)
Super Real Baseball '88 (J)	超级实战棒球'88(日)
Super Rugby (J)	超级橄榔球(日)
Super Spike V'Ball (E)
Super Spike V'Ball (U)
Super Spike V'Ball - Nintendo World Cup (U)
Super Sports Challenge (Aladdin) (E)
Super Sprint (J)	超级冲刺赛(日)
Super Sprint (U)	超级冲刺赛(美)
Super Spy Hunter (U)	超级间谍猎人(美)
Super Star Force (J)	星际战争(日)
Super Team Games (U)	校际运动会(美)
Super Turrican (E)	超级炮塔(欧)
Super Xevious - Gump no Nazo (J)	超级铁板阵/超级太空战机(日)
Superman (J)	超人(日)
Superman (U)	超人(美)
Superstar Pro Wrestling (J)	超级明星摔角决斗场(日)
Swamp Thing (U)	沼泽怪(美)
SWAT - Special Weapons and Tactics (J)	SWAT特警队/SWAT特种部队(日)
Sweet Home (J)	糖果屋(日)
Sword Master (E)	剑王(欧)
Sword Master (J)	剑王(日)
Sword Master (U)	剑王(美)
Swords and Serpents (E)	剑与大毒蛇(欧)
Swords and Serpents (U)	剑与大毒蛇(美)
T&C 2 - Thrilla's Surfari (U)	滑板2(美)
T&C Surf Design (U)	滑板(美)
Taboo - The Sixth Sense (U)	禁忌-第六感觉(美)
Tag Team Pro-Wrestling (J)	组合摔跤(日)
Tag Team Wrestling (U)	组合摔跤(美)
Tagin' Dragon (U)	迷宫龙(美)
Taito Basketball (J)	TAITO篮球(日)
Taito Chase HQ (J)	TAITO赛车(日)
Taito Grand Prix - Eikou heno License (J)	追击(日)
Taiyou no Shinden - Asteka 2 (J)	太阳神殿(日)
Taiyou no Yuusha Fighbird (J)
Takahashi Meijin no Boukenjima (J)	高桥名人的冒险岛(日)
Takahashi Meijin no Boukenjima 2 (J)	高桥名人的冒险岛2(日)
Takahashi Meijin no Boukenjima 3 (J)	高桥名人的冒险岛3(日)
Takahashi Meijin no Boukenjima 4 (J)	高桥名人的冒险岛4(日)
Takahashi Meijin no Bugutte Honey (J)	冒险岛外传-高桥名人的智力挑战(日)
Takeda Shingen (J)	武田信玄(日)
Takeda Shingen 2 (J)	武田信玄2(日)
Takeshi no Chousenjou (1986) (J)
Takeshi no Chousenjou (1990) (J)
Takeshi no Sengoku Fuuunji (J)	战国风云儿(日)
TaleSpin (E)
TaleSpin (U)
Tamura Koushou Mahjong Seminar (J)	田村光昭的麻雀大会(日)
Tanigawa Kouji no Shougi Shinan 2 (J)	谷川浩司的将棋指南2(日)
Tanigawa Kouji no Shougi Shinan 3 (J)	谷川浩司的将棋指南3(日)
Tantei Jinguuji Saburou - Toki no Sugiyuku Mama ni (J)	侦探神宫寺三郎-时间的痕迹(日)
Tantei Jinguuji Saburou - Yokohamakou Renzoku Satsujin Jiken (J)	侦探神宫寺三郎-危险的二人(日)
Tao (J)	道(日)
Target Renegade (U)	双截龙4(美)
Tashiro Masashi no Princess ga Ippai (J)	田代的魔界冒险(日)
Tatakae!! Rahmen Man - Sakuretsu Choujin 102 Gei (J)
Tatakai no Banka (Trojan) (J)	斗者挽歌(日)
Tecmo Baseball (U)	特库摩棒球(美)
Tecmo Bowl (J)	特库摩保龄球(日)
Tecmo Bowl (PRG 1) (U)	特库摩保龄球(美)
Tecmo Bowl (Prototype) (U)	特库摩保龄球(工程版)(美)
Tecmo Bowl (U)	特库摩保龄球(美)
Tecmo Cup - Soccer Game (U)	天使之翼/足球小将(美)
Tecmo NBA Basketball (U)	特库摩NBA篮球(美)
Tecmo Super Bowl (J)	特库摩超级美式足球(日)
Tecmo Super Bowl (U)	特库摩超级美式足球(美)
Tecmo World Cup Soccer (J)	世界杯足球赛(日)
Tecmo World Wrestling (E)	特库摩世界摔交(欧)
Tecmo World Wrestling (U)	特库摩世界摔交(美)
Teenage Mutant Hero Turtles (E)	忍者神龟1(欧)
Teenage Mutant Hero Turtles 2 (E)	忍者神龟2(欧)
Teenage Mutant Ninja Turtles (I)	忍者神龟1
Teenage Mutant Ninja Turtles (J)	忍忍者神龟2(日)
Teenage Mutant Ninja Turtles (U)	忍者神龟1(美)
Teenage Mutant Ninja Turtles 2 (J)	忍者神龟2(日)
Teenage Mutant Ninja Turtles 2 (U)	忍者神龟2(美)
Teenage Mutant Ninja Turtles 3 (U)	忍者神龟3(美)
Teenage Mutant Ninja Turtles Tournament Fighters (U)	激龟快打/忍者神龟格斗版(美)
Tenchi wo Kurau (J)	吞食天地(日)
Tenchi wo Kurau 2 - Shokatsu Koumei Den (J)	吞食天地2-诸葛孔明传(日)
Tenkaichi Bushi - Keru Naguuru (J)	天下第一武士(日)
Tennis (E)	网球(欧)
Tennis (JU)	网球(日)
Terao no Dosukoi Oozumou (J)	寺尾大相扑(日)
Terminator 2 - Judgement Day (E)	终结者2(欧)
Terminator 2 - Judgement Day (J)	终结者2(美)
Terminator 2 - Judgement Day (Prototype) (U)	终结者2(工程版)(美)
Terminator 2 - Judgement Day (U)	终结者2(美)
Terminator, The (U)	魔鬼终结者(美)
Terra Cresta (J)	神鹰1号(日)
Terra Cresta (U)	神鹰1号(美)
Tetrastar - The Fighter (J)	战斗之星(日)
Tetris (U)	方块/俄罗斯方块(美)
Tetris (J)	方块/俄罗斯方块(日)
Tetris 2 (U)	方块2/俄罗斯方块(美)
Tetris 2 (E)	方块2/俄罗斯方块(欧)
Tetris 2 + Bombliss (J)	方块2+炸弹方块/俄罗斯方块2+炸弹方块(日)
Tetris Flash (J)	闪光俄罗斯方块(日)
Tetsudou Ou - Famicom Boardgame (J)	铁道王(日)
Tetsuwan Atom (J)	铁臂阿童木/原子小金刚(日)
Thexder (J)	变形战机(日)
Three Stooges (Prototype) (U)
Three Stooges (U)
Thunder & Lightning (U)	新版打砖块(美)
Thunderbirds (J)	雷鸟援救队/雷鸟号(日)
Thunderbirds (U)	雷鸟援救队/雷鸟号(美)
Thundercade (U)	雷电节奏/特种部队(美)
Tiger-Heli (E)	虎式直升机(欧)
Tiger-Heli (J)	虎式直升机(日)
Tiger-Heli (U)	虎式直升机(美)
Tiles of Fate (U)
Time Diver Avenger (C)	时间旅行者(中)
Time Lord (E)	时间统治者(欧)
Time Lord (U)	时间统治者(美)
Time Zone (J)	时空地带 (日)
Times of Lore (J)	时空勇士(日)
Times of Lore (U)	时空勇士(美)
Tiny Toon Adventures (J)	兔宝宝历险记(日)
Tiny Toon Adventures (U)	兔宝宝历险记(美)
Tiny Toon Adventures 2 - Montana Land he Youkoso (J)	兔宝宝历险记2(日)
Tiny Toon Adventures 2 - Trouble in Wackyland (U)	兔宝宝历险记2(美)
Tiny Toon Adventures Cartoon Workshop (U)	兔宝宝卡通创作室(美)
Titan (J)	泰坦方块(日)
To The Earth (U)	去地球(美)
Toki (U)	JUJU传说(美)
Toki no Tabibito (J)	时空旅人(日)
Tokkyuu Shirei - Solbrain (J)	特救指令(日)
Tokoro San no Mamoru mo Semeru mo (J)	百战大出击(日)
Tom & Jerry (and Tuffy) (J)	汤姆和杰瑞/猫和老鼠(日)
Tom & Jerry (and Tuffy) (U)	汤姆和杰瑞/猫和老鼠(美)
Tom Sawyer no Bouken (J)	汤姆索亚大冒险(日)
Tombs and Treasure (U)
Tonjan! (J)	游戏空间(日)
Toobin (U)
Top Gun (E)	捍卫战士/壮志凌云(欧)
Top Gun (J)	捍卫战士/壮志凌云(日)
Top Gun (U)	捍卫战士/壮志凌云(美)
Top Gun - Dual Fighters (J)	捍卫战士2(日)
Top Gun - The Second Mission (E)	捍卫战士2(日)
Top Gun - The Second Mission (U)	捍卫战士2(日)
Top Rider (J)	顶级摩托车(日)
Top Striker (J)	顶级足球员(日)
Total Recall (U)
Totally Rad (E)
Totally Rad (U)
Totsuzen! Machoman (J)	突然君(日)
Touch Down Fever (J)	美式橄榄球(日)
Touch Down Fever (U)	美式橄榄球(美)
Touhou Kenbun Roku (J)
Toukon Club (J)
Toukyou Pachi Slot Adventure (J)	东京柏青哥大冒险/东京派金宫大冒险(日)
Tower of Druaga, The (J)	多鲁亚加塔(日)
Toxic Crusaders (U)
Track & Field (U)	奥运会(美)
Track & Field 2 (E)	奥运会2(欧)
Track & Field 2 (U)	奥运会2(美)
Track & Field in Barcelona (E)	巴塞罗那奥运会(欧)
Transformers - Comvoy no Nazo (J)	变形金刚(日)
Treasure Master (U)	寻宝大师(美)
Triathron, The (J)	铁人竞技(日)
Trog (U)
Trojan (E)	斗者挽歌(欧)
Trojan (U)	斗者挽歌(美)
Trolls in Crazyland (E)	游园地(欧)
Trolls on Treasure Island (U)	Trolls在金银岛(美)
Tsuppari Oozumou (J)	大相扑(日)
Tsuppari Wars (J)	相扑大战(日)
Tsuri Kichi Sanpei - Blue Marlin Hen (J)	钓鱼迷三平(日)
Tsuru Pika Hagemaru - Mezase! Tsuru Seko no Akashi (J)
Turbo Racing (E)
Twin Cobra (U)	究极虎(美)
Twin Eagle (U)	双鹰(美)
Twin Eagle - Revenge Joe's Brother (J)	双鹰(日)
TwinBee (J)	兵蜂(日)
TwinBee 3 - Poko Poko Dai Maou (J)	兵蜂3(日)
Uchuu Keibitai SDF (J)	宇宙警备队(日)
Uchuusen - Cosmo Carrier (J)	宇宙船COSMO(日)
U-Force Test Cartridge (U)
Ufouria (E)
Ultima - Exodus (U)
Ultima - Kyoufu no Exodus (J)	创世纪(神剑除魔)(日)
Ultima - Quest of the Avatar (U)
Ultima - Seija heno Michi (J)
Ultima - Warriors of Destiny (U)
Ultimate Air Combat (U)	空中战斗(美)
Ultimate Basketball (U)	最终篮球(美)
Ultimate League Soccer (U)
Ultimate Stuntman (U)	最终特技人(美)
Ultraman Club - Kaijuu Dai Kessen!! (J)	咸蛋超人俱乐部(日)
Ultraman Club 2 - Kaettekita Ultraman Club (J)	咸蛋超人俱乐部2(日)
Ultraman Club 3 (J)	咸蛋超人俱乐部3(日)
Uncharted Waters (U)	大航海时代(美)
Uninvited (U)
Untouchables, The (J)	执法先锋(日)
Untouchables, The (U)	执法先锋(美)
Urban Champion (JU)	街头格斗小子(日,美)
Urusei Yatsura - Lum no Wedding Bell (J)	福星小子(日)
US Championship V'Ball (J)	沙滩排球(日)
USA Ice Hockey in FC (J)	USA冰上曲棍球(日)
Ushio to Tora - Shinen no Daiyou (J)	魔力小马(日)
Utsurun Desu (J)	传染总动员(日)
Valis - The Fantastic Soldier (J)	梦幻战士(日)
Vegas Connection - Casino Kara Ai wo Komete (J)	赌城大集合(日)
Vegas Dream (U)
Venice Beach Volleyball (U)
Venus Senki (J)	维纳斯战记(金星战记)(日)
Vice - Project Doom (U)	火炮(美)
Videomation (U)
Vindicators (U)	维护者坦克(美)
Viva! Las Vegas (J)	万岁拉斯维加斯(日)
Volguard II (J)	变形金刚2(日)
Volleyball (U)	排球(美)
Wacky Races (U)	顽皮狗(美)
Wagan Land (J)	冒险世界1(瓦强世界1)(日)
Wagan Land 2 (J)	冒险世界2(瓦强世界2)(日)
Wagan Land 3 (J)	冒险世界3(瓦强世界3)(日)
Wai Wai World (J)	柯纳米世界(KONAMI世界)(日)
Wai Wai World 2 - SOS!! Paseri Jou (J)	柯纳米世界2(KONAMI世界2)(日)
Wai Xing Zhan Shi (C)	外星战士(中)
Walkuere no Bouken - Toki no Kagi Densetsu (J)
Wall Street Kid (U)	墙壁街小子(美)
Wally Bear and the No Gang (U)	威利熊(美)
Wanpaku Duck Yume Bouken (J)	唐老鸭梦冒险(日)
Wanpaku Kokkun no Gourmet World (J)	超级厨师(天才厨师)(日)
Wario no Mori (J)	坏玛利森林(瓦里奥森林)(日)
Wario's Woods (U)	坏玛利森林美版(瓦里奥森林)(美)
Warpman (J)	WARP MAN(日)
Wayne Gretzky Hockey (U)	冰上曲棍球(美)
Wayne's World (U)	Wayne's World(美)
WCW World Championship Wrestling (U)	WCW世界摔角赛(美)
Werewolf - The Last Warrior (U)	超人狼战记(美)
Western Kids (J)	西部小子(日)
Wheel of Fortune (U)	转轮台(美)
Wheel of Fortune - Starring Vanna White (U)	转轮台星星版(美)
Wheel of Fortune Family Edition (U)	转轮台家庭版(美)
Wheel of Fortune Junior Edition (U)	转轮台初级版(美)
Where in Time is Carmen Sandiego (U)	Where in Time is Carmen Sandiego(美)
Where's Waldo (U)	Waldo在哪里(美)
White Lion Densetsu (J)	白狮子传说(日)
Who Framed Roger Rabbit (U)
Whomp'Em (U)	西游记2(美)
Widget (U)	Widget(美)
Wild Gunman (U)	荒野枪手(西部枪手)(美)
Wild Gunman (U)	荒野枪手(西部枪手)(美)
Willow (J)	威洛之旅WILLOW(日)
Willow (U)	威洛之旅WILLOW(美)
Wily & Light no Rockboard - That's Paradise (J)	洛克人大富翁(洛克人桌棋)(日)
Win, Lose or Draw (U)	赢、输、平局(美)
Wing of Madoola, The (J)	玛多拉之翼(日)
Winter Games (U)	冬季奥运会(美)
Wit's (J)	威兹超人(WIT'S)(日)
Wizardry - Legacy of Llylgamyn (J)	避邪除妖2(巫术2)(日)
Wizardry - Proving Grounds of the Mad Overlord (J)	避邪除妖(巫术)(日)
Wizardry - Proving Grounds of the Mad Overlord (U)	避邪除妖(巫术)(美)
Wizardry - The Knight of Diamonds (J)	避邪除妖3(巫术3)(日)
Wizardry - The Knight of Diamonds (U)	避邪除妖3(巫术3)(美)
Wizards & Warriors (E)	巫师与战士(欧)
Wizards & Warriors (U)	巫师与战士(美)
Wizards & Warriors 3 (U)	巫师与战士3 (美)
Wolverine (U)	狼人(美)
Woody Poko (J)	木偶奇遇记(日)
World Boxing (J)	世界拳击赛(世界拳王)(日)
World Champ (U)	世界冠军(美)
World Class Track Meet (U)
World Games (U)	世界运动会(美)
World Grand-Prix - Pole To Finish (J)	世界方程式大赛车(日)
World Super Tennis (J)	世界杯网球赛(世界超级网球)(日)
Wrath of the Black Manta (E)	忍者刑警(欧)
Wrath of the Black Manta (U)	忍者刑警(美)
Wrecking Crew (JUE)	马里奥敲砖工(磁碟机版)
Wrestlemania Challenge (E)	世界摔角大赛(欧)
Wurm (U)	地底大作战美版(地底战记)(美)
WWF King of the Ring (U)	WWF金腰带(美)
WWF Steel Cage Challenge (E)	WWF挑战赛(欧)
WWF Steel Cage Challenge (U)	WWF挑战赛(美)
WWF Wrestlemania (U)	WWF搏斗疯子(美)
WWF Wrestlemania Challenge (J)	WWF世界摔角大赛(日)
WWF Wrestlemania Challenge (U)	WWF世界摔角大赛(美)
Xenophobe (U)	Xenophobe(美)
Xevious (E)	铁板阵(欧)
Xevious (J)	铁板阵(日)
Xevious (U)	铁板阵(美)
Xexyz (U)	义龟报恩美版(乌龟报恩美版)(美)
Xiao Ma Li (C)	小玛莉(中)
Xing Ji Wu Shi - Super Fighter (C)	星际武士(中)
Yamamura Misa Suspense - Kyouto Hana no Misshitsu Satsujin Jiken (J)	京都花之密室杀人事件(日)
Yamamura Misa Suspense - Kyouto Ryuu no Tera Satsujin (J)	京都龙之寺杀人事件(日)
Yamamura Misa Suspense - Kyouto Zaiteku Satsujin Jiken (J)	京都财阀家杀人事件(日)
Yie Ar Kung-Fu (V1.2) (J)	功夫V1.2(功夫大师，功夫小子)(日)
Yie Ar Kung-Fu (V1.4) (J)	功夫V1.4(功夫大师，功夫小子)(日)
Yin He Shi Dai (C)	银河时代(中)
Yo! Noid (U)	溜溜球兔(美)
Yoshi (U)	耀奇(美)
Yoshi no Cookie (J)	耀奇的饼干日版(耀奇蛋糕)(日)
Yoshi no Tamago (J)	耀奇岛(日)
Yoshi's Cookie (U)	耀奇的饼干(美)
Youkai Club (J)	妖怪俱乐部(日)
Youkai Douchuuki (J)	妖怪道中记(日)
Young Indiana Jones Chronicles, The (U)	少年印地安那琼斯(美)
Ys (J)	伊苏国(日)
Ys 2 - Ancient Ys Vanished The Final Chapter (J)	伊苏国2(日)
Ys 3 - Wanderers From Ys (J)	伊苏国3(日)
Yu Zhou Zhan Jiang - Space General (C)	宇宙战将(中)
Yume Penguin Monogatari (J)	梦之企鹅物语(日)
Yuu Yuu Hakusho Final - Makai Saikyou Retsuden (C)	幽游白书(中)
Zanac (U)	银河号(Zanac战机)(美)
Zelda 2 - The Adventure of Link (PRG 2) (E)	萨尔达传说2(PRG 2)(欧)
Zelda 2 - The Adventure of Link (U)	萨尔达传说2(美)
Zelda 2 - The Adventure of Link (E)	萨尔达传说2(欧)
Zelda no Densetsu 1 - The Hyrule Fantasy (J)	萨尔达传说(日)
Zen Intergalactic Ninja (U)	银河武士(美)
Zenbei!! Pro Basket (J)	全美职业篮球(日)
Zhan Guo Qun Xiong Zhuan (C)	战国群雄传(中)
Zippy Race (J)	疯狂赛车(日)
Zoids - Chuuou Tairiku no Tatakai (J)	ZOIDS-中央大陆之战(日)
Zoids 2 - Zenebasu no Gyakushuu (J)	ZOIDS 2(日)
Zoids Mokushiroku (J)	ZOIDS-默示录(日)
Zombie Hunter (J)	ZOMBLE猎手(日)
Zombie Nation (U)	超级乌鸦天狗(美)
