3 Ninjas Kick Back (U)	忍杀三人组(美)
6-Pak (U)
16 Tiles Mahjong (Unl)	十六张麻将(Unl)
16 Ton (J) (Sega Channel)	世嘉频道(日)
36 Great Holes Starring Fred Couples (32X) (E)	高尔夫球(32X)(欧)
36 Great Holes Starring Fred Couples (32X) (JU)	高尔夫球(32X)(日美)
688 Attack Sub (U)	猎杀潜艇(美)
777 Casino (Unl)
A Ressha de Ikou MD - Take the 'A' Train (J)	列车!GO(日)
AAAHH!!! Real Monsters (JUE)	真实怪物(日美欧)
Aah! Harimanada (J)	播磨滩相扑(日)
Abrams Battle Tank (JUE) (r01)	坦克大战(日美欧)
Action 52-in-1 (Unl)	动作52合1(Unl)
Addams Family Values (JUE) (M3)	阿达姆斯家庭(日欧美)
Addams Family, The (U) (Beta) [a1]	阿达姆斯家庭(测试版)(A1)(美)
Addams Family, The (U) (Beta)	阿达姆斯家庭(测试版)(美)
Addams Family, The (U)	阿达姆斯家庭(美)
Advanced Daisenryaku - Deutsche Dengeki Sakusen (J)	大战略(日)
Adventures of Batman & Robin, The (E)	蝙蝠侠与罗宾汉(欧)
Adventures of Batman & Robin, The (JU)	蝙蝠侠与罗宾汉(日美)
Aero Blasters (JUE)	疾风战机(日美欧)
Aero the Acro-Bat (U)	飞翔蝙蝠(美)
Aero the Acro-Bat 2 (E)	飞翔蝙蝠2(欧)
Aero the Acro-Bat 2 (U)	飞翔蝙蝠2(美)
Aerobiz (U)	航空霸业(美)
Aerobiz Supersonic (U)	航空霸业-超音速(美)
After Burner (32X) (E)	冲破火网(32X)(欧)
After Burner (32X) (JU)	冲破火网(32X)(日美)
After Burner II (J)	冲破火网2(日)
After Burner II (U)	冲破火网2(美)
Air Busters (U)	疾风战机(美)
Air Diver (J)	空中驾驭者(日)
Air Diver (U)	空中驾驭者(美)
Air Management - Oozora ni Kakeru (J) [x]	航空霸业-大空に翔ける(日)
Air Management II - Koukuuou wo Mezase (J)	航空霸业2-航空王を目差せ(日)
Akumajou Dracula - Vampire Killer (J)	恶魔城.德拉裘拉-吸血鬼杀手(日)
Aladdin (Beta)	阿拉丁(测试版)
Aladdin (E)	阿拉丁(欧)
Aladdin (J)	阿拉丁(日)
Aladdin (U)	阿拉丁(美)
Alex Kidd - Cheongongmaseong (K)	天空的魔城(韩)
Alex Kidd - Tenkuu Majou (J)	天空的魔城(日)
Alex Kidd in the Enchanted Castle (E) [a1]	天空的魔城[a1](欧)
Alex Kidd in the Enchanted Castle (E)	天空的魔城(欧)
Alex Kidd in the Enchanted Castle (U)	天空的魔城(美)
Alien 3 (JUE)	异形3(日美欧)
Alien Soldier (E)	异形佣兵(欧)
Alien Soldier (J)	异形佣兵(日)
Alien Storm (JUE)	异形风暴(日美欧)
Alisia Dragoon (Beta)	龙骑士(测试版)
Alisia Dragoon (E)	龙骑士(欧)
Alisia Dragoon (JU)	龙骑士(日美)
Altered Beast (UE) (r02)	兽王记(欧美)
Ambition of Caesar (J)	凯萨雄心(日)
Ambition of Caesar II (J) [x]	凯萨雄心2(日)
American Gladiators (U)	美国夺标(美)
Andre Agassi Tennis (Beta)	阿加斯网球(测试版)
Andre Agassi Tennis (E) (r01)	阿加斯网球(欧)
Andre Agassi Tennis (U) (r00)	阿加斯网球(美)
Animaniacs (E)	三只笨鼠(欧)
Animaniacs (JU)	三只笨鼠(日美)
Another World (E)	另一世界(欧)
Aoki Ookami to Shiroki Meshika - Genchou Hishi (J)	苍狼与白鹿-成吉思汗(日)
Aq Renkan Awa (Ch) (Unl) [x]	阿Q连环炮
Aquatic Games Starring James Pond and the Aquabats, The (U)	海洋动物运动会(美)
Arcade Classics (JUE)	街机合集(日美欧)
Arch Rivals (U)	篮球(美)
Arcus Odyssey (J)	阿卡斯冒险(日)
Arcus Odyssey (U)	阿卡斯冒险(美)
Ariel - The Little Mermaid (UE)	美人鱼(美欧)
Arnold Palmer Tournament Golf (U)	阿诺德高尔夫锦标赛(美)
Arrow Flash (JUE)	宇宙战机(日美欧)
Art Alive! (U)	艺术生涯(美)
Art of Fighting (E)	龙虎之拳(欧)
Art of Fighting (U)	龙虎之拳(美)
Assault Suit Leynos (J)	机械战士雷诺斯(日)
Asterix and the Great Rescue (E) [x]	阿斯特瑞克斯-大救援(欧)
Asterix and the Great Rescue (U)	阿斯特瑞克斯-大救援(美)
Asterix and the Power of The Gods (E) (M4)	阿斯特瑞克斯-上帝之力(M4)(欧)
Asterix and the Power of The Gods (E) (M5) [x]	阿斯特瑞克斯-上帝之力(M5)[x](欧)
Atomic Robo-Kid (J) [x]	原子机械童(日)
Atomic Robo-Kid (U)	原子机械童(美)
Atomic Runner (E)	原子战士(欧)
Atomic Runner (U)	原子战士(美)
ATP Tour Championship Tennis (E)	ATP冠军网球赛(欧)
ATP Tour Championship Tennis (U)	ATP冠军网球赛(美)
Australian Rugby League (AU)	澳大利亚橄榄球(澳)
Awesome Possum (JUE)	胆小鼠(日美欧)
AWS Pro Moves Soccer (U)	太空足球(美)
Ayrton Senna's Super Monaco GP II (JE)	摩纳哥GP赛车2(日欧)
Ayrton Senna's Super Monaco GP II (U) [a1]	摩纳哥GP赛车2[a1](美)
Ayrton Senna's Super Monaco GP II (U)	摩纳哥GP赛车2(美)
B.O.B. (Beta)
B.O.B. (JUE) (r01)
Baby's Day Out (Beta)	天使在人间(测试版)
Baby's Day Out (U)	天使在人间(美)
Back to the Future Part III (U)	回到未来3(美)
Bad Omen (J) [x]	弹球(日)
Bahamut Senki (J) [a1][x]	巴哈姆特战记[a1][x](日)
Bahamut Senki (J) [x]	巴哈姆特战记(日)
Ball Jacks (JE)	杰克球(日欧)
Ballz (JUE)	球(日美欧)
Barbie Super Model (U)	超级巴比模特(美)
Barbie Vacation Adventure (U)	巴比假日冒险(美)
Bare Knuckle II (Beta)	怒之铁拳2(测试版)
Bare Knuckle III (Beta)	怒之铁拳3(测试版)
Bare Knuckle III (J)	怒之铁拳3(日)
Barkley Shut Up and Jam! (JUE)	巴克利和杰姆(日美欧)
Barkley Shut Up and Jam! 2 (JUE)	巴克利和杰姆2(日美欧)
Barney's Hide & Seek Game (U)	巴尼寻宝(美)
Barver Battle Saga - The Space Fighter (Ch) (Unl) [x]	空间战士
Bass Masters Classic Pro Edition (JUE)	巴斯钓鱼专业版(日美欧)
Bass Masters Classics (U)	巴斯钓鱼经典版(美)
Batman - Revenge of the Joker (U)	蝙蝠侠-爵克的复仇(美)
Batman (E)	蝙蝠侠(欧)
Batman (J)	蝙蝠侠(日)
Batman (U)	蝙蝠侠(美)
Batman Forever (JUE)	永远的蝙蝠侠(日美欧)
Batman Returns (U)	蝙蝠侠归来(美)
Battle Golfer Yui (J)	战斗高尔夫(日)
Battle Mania (J)	战斗玛利亚(日)
Battle Mania Daiginjo (J)	战斗玛利亚ダイグンジョ(日)
Battle Squadron (U)	武装中队(美)
Battlemaster (JUE)	战神(日美欧)
Battletech (U)	机甲争霸(美)
Battletoads (JUE)	忍者蛙(日美欧)
Battletoads and Double Dragon (U)	忍者蛙与双截龙(美)
BC Racers (32X) (JUE)	赛车(32X)(日美欧)
Beast Warriors (J)	野兽武士(日)
Beast Wrestler (U)	怪兽摔角(美)
Beauty and the Beast - Belle's Quest (U)	美女与野兽-美女的搜索(美)
Beauty and the Beast - Roar of the Beast (U)	美女与野兽-野兽之怒号(美)
Beavis and Butt-head (U)	两个傻瓜(美)
Berenstain Bears', The - Camping Adventure (U)	卷毛熊露营冒险(美)
Best of the Best - Championship Karate (E) [x]	空手道(欧)
Best of the Best - Championship Karate (U)	空手道(美)
Beyond Oasis (U)	雷神传说(美)
Beyond Zero Tolerance (U) (Beta)	零号特警-终极忍耐(测试版)(美)
Bible Adventures (U) (Unl)	圣经冒险(美)
Bill Walsh College Football (JUE)	比尔渥休足球(日美欧)
Bill Walsh College Football '95 (U)	比尔渥休足球(美)
Bimini Run (JUE)	高速竞艇(日美欧)
Bio-Hazard Battle (Beta)	生化战机(测试版)
Bio-Hazard Battle (UE)	生化战机(美欧)
Bio-Ship Paladin (JUE)	宇宙战舰(日美欧)
Bishoujo Senshi Sailor Moon (J)	ビショウジョ戦士(日)
Blackthorne (32X) (U)	暗黑世界(32X)(美)
Blades of Vengeance (JUE)	复仇之刃(日美欧)
Blaster Master 2 (U) [a1][x]	疾风战车2[a1][x](美)
Blaster Master 2 (U)	疾风战车2(美)
Block Out (U) (r01)	立体方块(美)
Blockbuster Competition II - NBA Jam TE & Judge Dredd (U)	爆炸灌篮2(美)
Bloodshot (UE)	血腥射击(美欧)
Blue Almanac (J)	蓝色年代(日)
Body Count (Beta)	僵尸伯爵(测试版)
Body Count (E)	僵尸伯爵(欧)
Bonanza Bros. (JUE) (r00) [a1]	龙凤神偷(r00)[a1](日美欧)
Bonanza Bros. (JUE) (r00)	龙凤神偷(r00)(日美欧)
Bonanza Bros. (JUE) (r01)	龙凤神偷(r01)(日美欧)
Bonkers (JUE)	邦卡猫大冒险(日美欧)
Boogerman - A Pick and Flick Adventure (U)	皮克急速大冒险(美)
Boogie Woogie Bowling (J)	动感保龄球(日)
Boxing Legends of the Ring (U)	拳击-新传说之王(美)
Bram Stoker's Dracula (E)	吸血鬼德拉裘拉之谜(欧)
Bram Stoker's Dracula (U)	吸血鬼德拉裘拉之谜(美)
Brett Hull Hockey '95 (JUE)	赫尔曲棍球'95(日美欧)
Brian Lara Cricket (E) (Jun 1995)	布莱恩板球(欧)
Brian Lara Cricket (JE) (Mar 1995) [x]	布莱恩板球(日欧)
Brian Lara Cricket 96 (E) (Apr 1996) [x]	布莱恩板球96(欧)
Brian Lara Cricket 96 (E) (Mar 1996)	布莱恩板球96(欧)
Brutal - Paws of Fury (E)	动物快打(欧)
Brutal - Paws of Fury (U)	动物快打(美)
Brutal Unleashed - Above the Claw (32X) (U)	动物快打(32X)(美)
Bubba n Stix (E)	布巴与史地克(欧)
Bubba n Stix (U)	布巴与史地克(美)
Bubble and Squeak (U)	泡泡与史威克之冒险(美)
Bubsy II (JUE)	音速狐2(日美欧)
Bubsy in Claws Encounters of the Furred Kind (JUE)	音速狐(日美欧)
Buck Rogers - Countdown to Doomsday (U)	别克罗杰最终审判(美)
Budokan - The Martial Spirit (U)	武道馆-大和魂(美)
Bugs Bunny in Double Trouble (U)	宾尼兔-危机重重(美)
Bulls vs Blazers - NBA Playoffs (J)	NBA公牛Vs湖人(日)
Bulls vs Blazers and the NBA Playoffs (JUE)	NBA公牛Vs湖人(日美欧)
Bulls vs Lakers and the NBA Playoffs (U)	NBA公牛Vs耐克(美)
Burning Force (E)	燃烧战队(欧)
Burning Force (J)	燃烧战队(日)
Burning Force (U)	燃烧战队(美)
Cadash (JU)	斩魔传(日美)
Caesars Palace (U)	凯撒皇宫(美)
Cal .50 - Caliber Fifty (J)	卡尔50(日)
Cal Ripken Jr. Baseball (U)	棒球(美)
California Games (U)	游戏加州(美)
Cannon Fodder (E)	炮灰向前冲(欧)
Captain America and the Avengers (E)	美军上尉与复仇者(欧)
Captain America and the Avengers (J) [a1]	美军上尉与复仇者[a1](日)
Captain America and the Avengers (J)	美军上尉与复仇者(日)
Captain Planet and the Planeteers (E)	外星指挥官(欧)
Captain Planet and the Planeteers (U)	外星指挥官(美)
Capt'n Havoc (E)	浩劫(欧)
Castle of Illusion - Fushigi no Oshiro Daibouken (J)	幻影堡垒-不可思议的御城大冒险(日)
Castle of Illusion Starring Mickey Mouse (U)	幻影堡垒-不可思议的御城大冒险(美)
Castlevania - Bloodlines (U)	恶魔城-血继界限(美)
Castlevania - The New Generation (Beta)	恶魔城-新之时代(测试版)
Castlevania - The New Generation (E)	恶魔城-新之时代(欧)
Centurion - Defender of Rome (U)	罗马保卫战(美)
Chakan - The Forever Man (UE)	查可-永恒之人(美欧)
Chameleon Kid (J)	变色龙(日)
Champions World Class Soccer (JUE) (M4)	世界杯足球(日美欧)
Championship Bowling (U)	冠军杯保龄(美)
Championship Pool (U)	撞球锦标赛(美)
Championship Pro-Am (U)	火柴遥控车(美)
Chaos Engine, The (Beta)	混乱机车(测试版)
Chaos Engine, The (E)	混乱机车(欧)
Chase H.Q. II (U)	总部追击2(美)
Chavez II (U)	职业拳击2(美)
Chelnov (J)	卡洛夫(日)
Chess (Unl)	象棋(Unl)
Chester Cheetah (U)	切斯特雄豹(美)
Chester Cheetah 2 - Wild Wild Quest (U)	切斯特雄豹2--寻求野性(美)
Chi Chi's Pro Challenge (U)	挑战高尔夫(美)
Chibi Maruko-Chan - Wakuwaku Shopping (J)	学校大富翁(日)
Chiki Chiki Boys (J)	世界勇者-双麟儿(日)
Chiki Chiki Boys (U)	世界勇者-双麟儿(美)
Chinese Chess (Unl)	中国象棋(Unl)
Chou Yakyuu Miracle Nine (J)	超球界(日)
Chuck Rock (U)	小原始人(美)
Chuck Rock II (Beta)	小原始人2(测试版)
Chuck Rock II (E)	小原始人2(欧)
Chuck Rock II (J)	小原始人2(日)
Chuck Rock II (U)	小原始人2(美)
Chuck's Excellent Art Tool Animator (JUE) [a1][c]	SEGA测试带[a1][c](日美欧)
Chuck's Excellent Art Tool Animator (JUE)	SEGA测试带(日美欧)
Classic Collection (E)	经典收藏(欧)
Clay Fighter (U)	粘土战士(美)
Cliffhanger (E)	史泰龙(欧)
Cliffhanger (U) [a1]	史泰龙[a1](美)
Cliffhanger (U)	史泰龙(美)
Clue (U)	暗示(美)
Coach K College Basketball (U)	K教练大学篮球(美)
College Football USA 96 (U)	美国大学足球96(美)
College Football USA 97 (U)	美国大学足球97(美)
College Football's National Championship (U)	大学美式足球冠军赛(美)
College Football's National Championship 2 (JUE)	大学美式足球冠军赛2(日美欧)
College Slam (U)	美式足球(美)
Columns (JUE) (r00)	宝石方块(r00)(日美欧)
Columns (JUE) (r01)	宝石方块(r01)(日美欧)
Columns III - Revenge of Columns (U)	宝石方块3(美)
Columns III - Taiketsu! Columns World (J)	宝石方块3(日)
Combat Aces (Beta)	战斗机师(测试版)
Combat Cars (U)	战斗赛车(美)
Comix Zone (Beta)	漫画地带(测试版)
Comix Zone (E)	漫画地带(欧)
Comix Zone (J)	漫画地带(日)
Comix Zone (U)	漫画地带(美)
Command & Conquer (Beta)	命令与征服(测试版)
Congo - The Game (Beta)	刚果漂流(测试版)
Conquering the World III (Ch) (Unl) [x] (simple chinese)	吞食天地3(中)
Conquering the World III (Ch) (Unl) [x]	吞食天地3(中)
Contra - Hard Corps (U)	魂斗罗(美)
Contra - The Hardcore (J)	魂斗罗(日)
Cool Spot (Beta)	七喜小子(测试版)
Cool Spot (E)	七喜小子(欧)
Cool Spot (U)	七喜小子(美)
Corporation (E)	毁灭战士(欧)
Cosmic Carnage (32X) (E)	宇宙大屠杀(32X)(欧)
Cosmic Carnage (32X) (JU)	宇宙大屠杀(32X)(日美)
Cosmic Spacehead (E)	宇宙首领(欧)
Crack Down (J) [a1]	爆裂激战[a1](日)
Crack Down (J)	爆裂激战(日)
Crack Down (UE)	爆裂激战(美欧)
Crayon Shin-chan - Arashi wo Yobu Enji (J)	蜡笔小新(日)
CrossFire (J)	交叉火力(日)
Crude Buster (J)	暴力克星(日)
Crue Ball (U)	弹珠台(美)
Crusader of Centy (U)	创世战士(美)
Crying - Aseimei Sensou (J)	海底战争(日)
Crystal's Pony Tale (U)	水晶小马(美)
Curse (J)	诅咒(日)
Cutie Suzuki no Ringside Angel (JUE)	马戏天使(日美欧)
Cutthroat Island (JUE)	割喉岛(日美欧)
Cyberball - Football in the 21st Century (JUE)	足球(日美欧)
Cyber-Cop (JUE)	机器警察(日美欧)
Cyborg Justice (U)	正义审判(美)
D&D - Warriors of the Eternal Sun (U)	龙与地下城(美)
Daffy Duck in Hollywood (Beta)	达菲鸭在好莱坞(测试版)
Daffy Duck in Hollywood (JUE) (M5)	达菲鸭在好莱坞(日美欧)
Dahna Megami Tanjou (J)	女神诞生(日)
Dai Konsen - General Chaos (J)	大混战(日)
Daikoukai Jidai (J) [x]	大航海时代(日)
Daikoukai Jidai II (J)	大航海时代2(日)
Daimakaimura (J) (r00)	大魔界村(日)
Dangerous Seed (J)	危机之种(日)
Darius II (J) [a1]	大流士2[a1](日)
Darius II (J)	大流士2(日)
Dark Castle (JUE)	暗黑之城(日美欧)
Darwin 4081 (J)	达尔文4081(日)
Darxide (32X) (E)	3D战机(32X)(欧)
Dashin' Desperadoes (Beta)	亡命之徒(测试版)
Dashin' Desperadoes (JU)	亡命之徒(日美)
David Crane's Amazing Tennis (U)	大卫杯网球赛(美)
David Robinson Basketball (J)	大卫罗宾逊篮球(日)
David Robinson's Supreme Court (U)	大卫罗宾逊篮球(美)
Davis Cup World Tour Tennis (Beta)	戴维斯世界杯网球赛(测试版)
Davis Cup World Tour Tennis (JUE)	戴维斯世界杯网球赛(日美欧)
Davis Cup World Tour Tennis 2 (E) (Beta)	戴维斯世界杯网球赛(测试版)(欧)
Davis Cup World Tour Tennis 2 (U) (Beta)	戴维斯世界杯网球赛(测试版)(美)
Daze Before Christmas, The (Beta)	圣诞狂欢夜(测试版)
Daze Before Christmas, The (E)	圣诞狂欢夜(欧)
Deadly Moves (J)	致命距离(日)
Death and Return of Superman, The (U)	超人-浴火重生(美)
Death Duel (JUE)	死亡决斗(日美欧)
Decap Attack Starring Chuck D. Head (UE)	僵尸大进击(美欧)
Demolition Man (JUE)	破坏者(日美欧)
Desert Demolition (JUE)	BB鸟与大野狼(日美欧)
Desert Strike - Return to the Gulf (U)	沙漠攻击(美)
Devil Crash MD (J)	死亡弹珠台MD(日)
Devilish (U)	恶魔波子机(美)
Devilish Mahjong Tower (Unl)	麻将恶魔塔(Unl)
Devil's Course - New 3D Golf Simulation (J)	恶灵之路-新3D高尔夫(日)
Dial Q Mahjang Club (J) [x]	麻雀俱乐部(日)
Dick Tracy (JUE)	迪克特蓝西(日美欧)
Dick Vitale's Awesome Baby! College Hoops (JUE)	迪克之大学篮球(日美欧)
Dino Dini's Soccer (E)	意大利足球(欧)
Dino Land (JUE)	恐龙大陆(日美欧)
Dinosaurs for Hire (U)	猛龙雇佣兵(美)
Disney Collection - Castle of Illusion & Quackshot (JUE)	迪斯尼幻想乐园(日美欧)
Divine Sealing (J)	捉虫敢死队(日)
DJ Boy (E)	DJ男孩(欧)
DJ Boy (J)	DJ男孩(日)
DJ Boy (U)	DJ男孩(美)
Doki Doki Penguin Land (J)	企鹅大陆(日)
Dominus (JUE) [x]	多米诺斯(日美欧)
Donald Duck in Maui Mallard (E)	唐老鸭(欧)
Doom (32X) (E)	毁灭公爵(32X)(欧)
Doom (32X) (JU)	毁灭公爵(32X)(日美)
Doom Troopers - The Mutant Chronicles (U)	毁灭骑兵(美)
Doraemon - Yume Dorobouto 7 Nin No Gozansu (J) [x]	多啦A梦-夢　泥棒と７忍ノゴザンス(日)
Double Clutch (JUE) [a1][x]	小赛车[a1][x](日美欧)
Double Clutch (JUE)	小赛车(日美欧)
Double Dragon (U)	双截龙(美)
Double Dragon 2 (J)	双截龙2(日)
Double Dragon 3 - The Arcade Game (U)	双截龙3-街机版(美)
Double Dragon V - The Shadow Falls (U)	双截龙5-失落之影(美)
Double Dribble - The Playoff Edition (U)	NBA季后赛(美)
Dr. Robotnik's Mean Bean Machine (Beta)	魔法气泡外传(测试版)
Dr. Robotnik's Mean Bean Machine (U)	魔法气泡外传(美)
Dragon - The Bruce Lee Story (E)	龙的传人-李小龙传说(欧)
Dragon - The Bruce Lee Story (U)	龙的传人-李小龙传说(美)
Dragon Ball Z - Buu Yuu Retsuden (J)	七龙珠-舞游列传(日)
Dragon Ball Z - L'Appel du Destin (F)	七龙珠-舞游列传(法)
Dragon Slayer - The Legend of Heroes (J)	屠龙英雄传(日)
Dragon Slayer - The Legend of Heroes II (J)	屠龙英雄传2(日)
Dragon's Eye - Shanghai 3 (J)	龙之目-上海3(日)
Dragon's Fury (UE)	龙之弹珠台(美欧)
Dragon's Revenge (JUE)	龙之弹珠台-革命版(日美欧)
Draxos (J)	屠魔大法师(日)
Duke Nukem 3D (B)	毁灭公爵3D(B)
Dune - Der Kampf um den Wuestenplaneten (G)	沙丘魔堡(德)
Dune - The Battle for Arrakis (E)	沙丘魔堡(欧)
Dune - The Building of a Dynasty (U)	沙丘魔堡(美)
Dyna Brothers (J) (r01)	恐龙兄弟(日)
Dyna Brothers 2 (J)	恐龙兄弟2(日)
Dynamite Duke (JUE) [a1]	毁灭公爵[a1](日美欧)
Dynamite Duke (JUE)	毁灭公爵(日美欧)
Dynamite Headdy (Beta)	大头小子(测试版)
Dynamite Headdy (J)	大头小子(日)
Dynamite Headdy (UE)	大头小子(美欧)
EA Hockey League (U)	EA曲棍球联赛(美)
EA Sports Double Header (E)	EA赛车联赛(欧)
Earnest Evans (U)	认真爱文(美)
Earthworm Jim (E)	蚯蚓吉姆(欧)
Earthworm Jim (U)	蚯蚓吉姆(美)
Earthworm Jim 2 (E) [x]	蚯蚓吉姆2(欧)
Earthworm Jim 2 (U)	蚯蚓吉姆2(美)
Ecco - The Tides of Time (E) (Beta)	小海豚-退潮后的游戏时间(测试版)(欧)
Ecco - The Tides of Time (E)	小海豚-退潮后的游戏时间(欧)
Ecco - The Tides of Time (U) (Beta) [a1]	小海豚-退潮后的游戏时间[a1](测试版)(美)
Ecco - The Tides of Time (U) (Beta)	小海豚-退潮后的游戏时间(测试版)(美)
Ecco - The Tides of Time (U)	小海豚-退潮后的游戏时间(美)
Ecco (J)	小海豚(日)
Ecco (U)	小海豚(美)
Ecco Jr. (JUE) (Feb 1995)	JR海豚(日美欧)
Ecco Jr. (JUE) (Mar 1995)	JR海豚(日美欧)
Ecco the Dolphin (32X) (CinePak Demo) (JUE)	海豚(32X)(日美欧)
El Viento (J)	EL维恩特(日)
El Viento (U)	EL维恩特(美)
Elemental Master (J)	元素支配者(日)
Elemental Master (U)	元素支配者(美)
Eliminate Down (J)	空战(日)
Elitserien 95 (SW)	曲棍球赛季95(SW)
Elitserien 96 (SW)	曲棍球赛季96(SW)
Escape From Mars Starring Taz (E)	火星逃脱者(欧)
Escape From Mars Starring Taz (U)	火星逃脱者(美)
ESPN Baseball Tonight (U)	夜色棒球(美)
ESPN National Hockey Night (Beta)	夜色曲棍球(测试版)
ESPN National Hockey Night (U)	夜色曲棍球(美)
ESPN SpeedWorld (U)	极速世界(美)
ESPN Sunday Night Football (U)	夜色足球(美)
ESWAT Cyber Police - City Under Siege (U)	武装行警(美)
ESWAT Cyber Police - Enhanced Special Weapons and Tactics (J)	武装行警(日)
Eternal Champions (Beta)	永恒之冠(测试版)
Eternal Champions (E)	永恒之冠(欧)
Eternal Champions (J)	永恒之冠(日)
Eternal Champions (U)	永恒之冠(美)
Europe Sensen (J)	征战欧洲(日)
European Club Soccer (E)	欧洲足球俱乐部(欧)
Evander Holyfield's Real Deal Boxing (U)	真实拳击(美)
Exile - Toki no Hazama he (J)	流放-时间之夹缝(日)
Exile (U)	流放(美)
Ex-Mutants (U)	EX-异种(美)
Exodus (U) (Unl)	依克斯达斯(Unl)(美)
Exo-Squad (U) (T-132026)	空中战警(T-132026)(美)
Exo-Squad (U) (T-132086)	空中战警(T-132086)(美)
Ex-Ranza (Beta)	鸟人战机(测试版)
Ex-Ranza (J)	鸟人战机(日)
F1 Circus MD (J)	F1赛车(日)
F1 World Championship (E)	F1世界锦标赛(欧)
F1 World Championship (U)	F1世界锦标赛(美)
F1 World Championship Edition (Beta) [a1]	F1世界锦标赛[a1](测试版)
F1 World Championship Edition (Beta)	F1世界锦标赛(测试版)
F1 World Championship Edition (E)	F1世界锦标赛(欧)
F-117 Night Storm (JUE)	F117死亡龙卷(日美欧)
F-117 Stealth - Operation Night Storm (Beta)	F117死亡龙卷(测试版)
F-15 Strike Eagle II (Beta)	F15猎鹰行动(测试版)
F-15 Strike Eagle II (E)	F15猎鹰行动(欧)
F-15 Strike Eagle II (U)	F15猎鹰行动(美)
F-22 Interceptor (Beta)	F22拦截机(测试版)
F-22 Interceptor (U) (Jun 1992)	F22拦截机(6月1992)(美)
F-22 Interceptor (U) (Sep 1991) [a1][c]	F22拦截机(9月1991)[a1][c](美)
F-22 Interceptor (U) (Sep 1991)	F22拦截机(9月1991)(美)
Faery Tale Adventure, The (U)	幻境传说(美)
Family Feud (U)	家庭竞赛(美)
Fantasia (E) (r00)
Fantasia (J) (r01)
Fantasia (U) (r00)
Fantastic Dizzy (UE) (M5) [a1]	鸡蛋冒险(M5)[a1](美欧)
Fantastic Dizzy (UE) (M5)	鸡蛋冒险(M5)(美欧)
Fastest 1 (J)	大赛车(日)
Fatal Fury - King of Fighters (E)	饿狼传说1(欧)
Fatal Fury - King of Fighters (U)	饿狼传说1(美)
Fatal Fury 2 (UE)	饿狼传说2(美欧)
Fatal Labyrinth (JUE)	致命迷宫(日美欧)
Fatal Rewind (U)	机械战狗(欧)
Fatman (J)	肥人(日)
Fengshen Yingjiechuan (Ch) (Unl) [x]	封神英杰传(中)
Ferias Frustradas do Pica-Pau (B)	火烈鸟(B)
Ferrari Grand Prix Challenge (Beta)	长途汽车挑战赛(测试版)
Ferrari Grand Prix Challenge (U)	长途汽车挑战赛(美)
Fever Pitch Soccer (E) (M5)
Fido Dido (U)	七喜小子(美)
FIFA International Soccer (JUE) (M4)	FIFA国际足球(日美欧)
FIFA International Soccer 96 (32X) (JUE)	FIFA国际足球96(32X)(日美欧)
FIFA Soccer 95 (JUE) (M4)	FIFA足球95(M4)(日美欧)
FIFA Soccer 96 (JUE) (M6)	FIFA足球96(M6)(日美欧)
FIFA Soccer 97 Gold Edition (UE) (M6)	FIFA足球97黄金版(美欧)
FIFA Soccer 98 - Road to the World Cup (E) (M5)	FIFA足球98-通向世界杯之路(欧)
Fighting Masters (J)	星际主人(日)
Fighting Masters (U)	星际主人(美)
Final Blow (J)	拳击(日)
Final Zone (JU)	终极战区(日美)
Fire Mustang (J)	烈焰军刀(日)
Fire Shark (U) [a1]	鲛!鲛!鲛![a1](美)
Fire Shark (U) [a2]	鲛!鲛!鲛![a2](美)
Fire Shark (U)	鲛!鲛!鲛!(美)
Flashback - The Quest for Identity (E)	闪电归来-永恒的追寻(欧)
Flashback - The Quest for Identity (J)	闪电归来-永恒的追寻(日)
Flashback - The Quest for Identity (U) [a1]	闪电归来-永恒的追寻[a1](美)
Flashback - The Quest for Identity (U)	闪电归来-永恒的追寻(美)
Flicky (JUE)	小鸟崔弟(日美欧)
Flintstones, The (E)	石头族乐园(欧)
Flintstones, The (J) [x]	石头族乐园(日)
Flintstones, The (U)	石头族乐园(美)
Foreman for Real (JUE)	真实拳击(日美欧)
Forgotten Worlds (JUE) (r00)	世界末日(r00)(日美欧)
Forgotten Worlds (JUE) (r01)	世界末日(r01)(日美欧)
Frank Thomas Big Hurt Baseball (JUE)	法兰克汤姆斯棒球(日美欧)
Frogger (JU)	青蛙过街(日美)
From TV Animation Slam Dunk - Kyougou Makkou Taiketsu! (J)	篮球飞人-高手 正面的对决(日)
Fun Car Rally (U) (Beta)	玩具车拉力赛(美)
Fun-n-Games (E)	玩具游戏(欧)
Fun-n-Games (U)	玩具游戏(美)
Fushigi no Umi no Nadia (J)	深海之迷(日)
Gadget Twins, The (U)	双胞小飞机(美)
Gaiares (JU)	宇宙巡航机(日美)
Gain Ground (JUE) [a1]	领土扩展[a1](日美欧)
Gain Ground (JUE)	领土扩展(日美欧)
Galaxy Force II (JU) (r00)	星际力量2(r00)(日美)
Galaxy Force II (JUE) (r01)	星际力量2(r01)(日美欧)
Gambler Jiko Chuushinha - Katayama Masayuki no Mahjong Doujou (J)	麻将道场(日)
Game no Kanzume Otokuyou (J)
Garfield - Caught in the Act (UE)	加菲猫(美欧)
Gargoyles (U)	魔界使者(美)
Garou Densetsu - Shukumei no Tatakai (J)	饿狼传说1(日)
Garou Densetsu 2 - Aratanaru Tatakai (J)	饿狼传说2(日)
Gauntlet 4 (J)	铁腕战士(日)
Gauntlet 4 (UE) (Aug 1993)	铁腕战士(8月1993)(美欧)
Gauntlet 4 (UE) (Sep 1993)	铁腕战士(9月1993)(美欧)
GemFire (U)	皇家血裔(美)
General Chaos (JUE)	大混斗(日美欧)
Generations Lost (JUE)	失落的世界(日美欧)
Genghis Khan II - Clan of the Gray Wolf (U)	元朝秘史2-苍狼与白鹿(美)
George Foreman's KO Boxing (E)	拳击(欧)
George Foreman's KO Boxing (U)	拳击(美)
Ghost Hunter (Unl)	捉鬼大师(Unl)
Ghostbusters (JUE) (r00)	魔鬼克星(r00)(日美欧)
Ghostbusters (JUE) (r01)	魔鬼克星(r01)(日美欧)
Ghouls'n Ghosts (JUE) (r01)	大魔界村(r01)(日美欧)
Ghouls'n Ghosts (JUE) (r02)	大魔界村(r02)(日美欧)
Gley Lancer (J)	星际枪骑兵(日)
G-LOC Air Battle (Beta)	G-Loc空战(测试版)
G-LOC Air Battle (JUE)	G-Loc空战(日美欧)
Gods (Beta)	异神战士(Beta)
Gods (E)	异神战士(欧)
Gods (J)	异神战士(日)
Gods (U)	异神战士(美)
Golden Axe (JUE) (r00)	战斧(r00)(日美欧)
Golden Axe (JUE) (r01)	战斧(r01)(日美欧)
Golden Axe II (Beta)	战斧2(Beta)
Golden Axe II (JUE)	战斧(日美欧)
Golden Axe III (J)	战斧3(日)
Goofy's Hysterical History Tour (U)	果菲狗(美)
Gouketsuji Ichizoku (J)
Granada (J) (r00)	格兰达战记(日)
Granada (U) (r01)	格兰达战记(美)
Grand Slam - The Tennis Tournament '92 (J)	大满贯网球92(日)
Grand Slam Tennis (E)	大满贯网球(欧)
Great Circus Mystery Starring Mickey & Minnie, The (U)
Great Circus Mystery, The - Mickey to Minnie Magical Adventure 2 (J)
Great Waldo Search, The (U)	沃尔多大法师(美)
Greatest Heavyweights of the Ring (J)
Greatest Heavyweights of the Ring (U)
Greendog - The Beached Surfer Dude (U)	绿狗(美)
Grind Stormer (U)	碾磨暴风雨(美)
Growl (U)	咆哮如雷(美)
Gunship (JUE)	武装直升机(日美欧)
Gunstar Heroes (E)	火枪英雄(欧)
Gunstar Heroes (J)	火枪英雄(日)
Gunstar Heroes (U)	火枪英雄(美)
Gunstar Heroes Sample (J)	火枪英雄演示版(日)
Gynoug (E)	翼人(欧)
Gynoug (J)	翼人(日)
Hard Drivin' (JUE)	迅猛赛车(日美欧)
HardBall '94 (JUE)	硬派棒球94(日美欧)
HardBall '95 (JUE)	硬派棒球95(日美欧)
HardBall III (JUE)	硬派棒球3(日美欧)
HardBall! (U)	硬派棒球!(美)
Haunting, The (JUE)	幽灵(日美欧)
Head-On Soccer (U) (M5)	足球(美)
Heavy Nova (JUE)	重装诺瓦(日美欧)
Heavy Unit (J)	重兵压境(日)
Hellfire (E)	地狱火(欧)
Hellfire (J)	地狱火(日)
Hellfire (U)	地狱火(美)
Herzog Zwei (J)	离子战机(日)
Herzog Zwei (UE)	离子战机(美欧)
High Seas Havoc (U)	大海哮--火箭骑士(美)
Hit The Ice (U)	暴力冰球(美)
Hokuto no Ken - Seikimatsu Kyuuseishu Densetsu (J)	北斗神拳-世纪末救世主传说(日)
Home Alone (U) (Beta)	小鬼当家(测试版)(美)
Home Alone (U)	小鬼当家(美)
Home Alone 2 - Lost in New York (U)	小鬼当家2(美)
Honoo no Toukyuuji Dodge Danpei (J)
Hook (U)	小飞侠(美)
Humans, The (U)	新人类(美)
Hurricanes (JUE)	狂风(日美欧)
Hybrid Front, The (J) [a1]	轨道战争(日)
Hyokkori Hyoutanjima - Daitouryou wo Mezase! (J) [x]	大统领(日)
Hyper Dunk - The Playoff Edition (E)	疯狂灌篮-季后赛(欧)
Hyper Dunk - The Playoff Edition (J)	疯狂灌篮-季后赛(日)
Hyper Marbles (J) (Sega Channel)	大碰撞(日)
IMG International Tour Tennis (JUE)	网球巡回赛(日美欧)
Immortal, The (J)	死神传说(日)
Immortal, The (U)	死神传说(美)
Incredible Crash Dummies, The (Beta)	铁人狂奔(测试版)
Incredible Crash Dummies, The (JUE)	铁人狂奔(日美欧)
Incredible Hulk, The (JUE)	绿巨人(日美欧)
Indiana Jones and the Last Crusade (JE)	印第安那琼斯(日欧)
Indiana Jones and the Last Crusade (U)	印第安那琼斯(美)
Insector X (JUE) (Jul 1990)	兵蜂X(6月1990)(日美欧)
Insector X (JUE) (Jun 1990)	兵蜂X(7月1990)(日美欧)
Instruments of Chaos Starring Young Indiana Jones (Beta)	少年印第安那琼斯(测试版)
Instruments of Chaos Starring Young Indiana Jones (J)	印第安那琼斯(日)
Instruments of Chaos Starring Young Indiana Jones (U)	印第安那琼斯(美)
International Rugby (JUE)	国际橄榄球(日美欧)
International Superstar Soccer Deluxe (Beta)	国际全明星足球(测试版)
International Superstar Soccer Deluxe (JUE)	国际全明星足球(日美欧)
Ishido - The Way of Stones (U)	石头棋(美)
It Came From The Desert (U) [x]	流沙斗士(美)
Itchy and Scratchy Game, The (JUE)
Izzy's Quest for the Olympic Rings (JUE)	百年奥运会(日美欧)
J. League Champion Soccer (J)	J联盟足球(日)
J. League Pro Striker - Final Stage (J)	J联盟完美射手(日)
J. League Pro Striker 2 (J)	J联盟完美射手2(日)
J. League Pro Striker '93 (J) (r00)	J联盟完美射手93(r00)(日)
J. League Pro Striker '93 (J) (r03)	J联盟完美射手93(r03)(日)
J. League Pro Striker Perfect (J)	J联盟完美射手完全版(日)
Jack Nicklaus' Power Challenge Golf (JUE)	高尔夫(日美欧)
James Bond - The Duel (E)	詹姆斯庞德-对决(欧)
James Bond - The Duel (J)	詹姆斯庞德-对决(日)
James Bond - The Duel (U)	詹姆斯庞德-对决(美)
James Buster Douglas Knock Out Boxing (U)	道格拉斯拳击(美)
James Pond - Underwater Agent (U)	詹姆斯庞德-水下代码(美)
James Pond 3 - Operation Starfish (JUE)	詹姆斯庞德3-海星行动(日美欧)
James Pond II - Codename Robocod (U)	詹姆斯庞德2-代号无人机(美)
Jammit (U)	街头篮球(美)
Jantei Monogatari (J)	雀侦物语(日)
Jelly Boy (JUE) [x]	果冻男孩(日美欧)
Jennifer Capriati Tennis (U)	詹尼佛网球(美)
Jeopardy! (U)	智力问答(美)
Jeopardy! Deluxe (JUE)	智力问答豪华版(日美欧)
Jeopardy! Sports Edition (U)	智力问答体育项目(美)
Jerry Glanville's Pigskin Footbrawl (U)	杰瑞橄榄球(美)
Jewel Master (J)	宝石战士(日)
Jewel Master (U)	宝石战士(美)
Jim Power - The Arcade Game (JUE)	吉姆力量-街机游戏(日美欧)
Jimmy White's Whirlwind Snooker (E)	吉姆怀特的立体桌球(欧)
Joe & Mac Caveman Ninja (U)	战斗原始人(美)
Joe Montana Football (U)	约翰麦登橄榄球(美)
Joe Montana Sports Talk Football (U)	约翰麦登实况橄榄球(美)
Joe Montana Sports Talk Football 2 (U) (r00)	约翰麦登实况橄榄球2(r00)(美)
Joe Montana Sports Talk Football 2 (U) (r01)	约翰麦登实况橄榄球2(r01)(美)
John Madden Football 91 (U)	约翰麦登橄榄球91(美)
John Madden Football 92 (U)	约翰麦登橄榄球92(美)
John Madden Football 93 - Championship Edition (U)	约翰麦登橄榄球93-冠军赛(美)
John Madden Football 93 (U)	约翰麦登橄榄球93(美)
John Madden NFL 94 (JUE)	约翰麦登橄榄球94(日美欧)
Jordan vs Bird - Super One-on-One (J) (r00)	乔丹对伯得-超级一对一(r00)(日)
Jordan vs Bird - Super One-on-One (U) (r00)	乔丹对伯得-超级一对一(r00)(美)
Jordan vs Bird - Super One-on-One (U) (r01)	乔丹对伯得-超级一对一(r01)(美)
Joshua & The Battle of Jericho (U) (Unl)
Judge Dredd - The Movie (Beta) [a1]	超时空战警[a1](测试版)
Judge Dredd - The Movie (Beta)	超时空战警(测试版)
Judge Dredd - The Movie (JUE)	超时空战警(日美欧)
JuJu Densetsu (J)	JuJu传说(日)
Junction (JUE)	晃球游戏(日美欧)
Jungle Book, The (E)	泰山传奇(欧)
Jungle Book, The (U)	泰山传奇(美)
Jungle Strike (Beta)	丛林攻击(测试版)
Jungle Strike (JUE) (Apr 1993)	丛林攻击(4月1993)(日美欧)
Jungle Strike (JUE) (Dec 1993)	丛林攻击(12月1993)(日美欧)
Jurassic Park - Rampage Edition (JUE)	侏罗纪公园-狂暴版(日美欧)
Jurassic Park (Beta)	侏罗纪公园(测试版)
Jurassic Park (E)	侏罗纪公园(欧)
Jurassic Park (J)	侏罗纪公园(日)
Jurassic Park (U)	侏罗纪公园(美)
Jurassic Park 2 - The Lost World (JUE)	侏罗纪公园2-失落的世界(日美欧)
Justice League Task Force (JUE)	正义联盟超人格斗(日美欧)
Juuohki (J) (r00)	兽王记(r00)(日)
Juuohki (J) (r01)	兽王记(r01)(日)
Ka-Ge-Ki - Fists of Steel (J)	火激(日)
Ka-Ge-Ki - Fists of Steel (U)	火激(美)
Kawasaki Superbike Challenge (Beta)	川崎机车赛(测试版)
Kawasaki Superbike Challenge (JUE)	川崎机车赛(日美欧)
Kick Boxing, The (J)
Kick Off 3 - European Challenge (E)	K.O足球-欧洲联赛(欧)
Kid Chameleon (UE)	变色龙(美欧)
Killing Game Show, The (J)	机械精灵(日)
King of the Monsters (E)	万兽之王(欧)
King of the Monsters (U)	万兽之王(美)
King of the Monsters 2 (U)	万兽之王2(美)
King Salmon (J) [x]	鲑鱼王(日)
King Salmon (U)	鲑鱼王(美)
King's Bounty (U)	国王之恩典(美)
Klax (J)	立体方块(日)
Klax (U)	立体方块(美)
Knuckles Chaotix (32X) (E)	索尼克(32X)(欧)
Knuckles Chaotix (32X) (JU)	索尼克(32X)(日美)
Kolibri (32X) (JUE)	蜂鸟(32X)(日美欧)
Koutetsu Teikoku (J)	钢铁帝国(日)
Krusty's Super Funhouse (JUE) (r00)
Krusty's Super Funhouse (JUE) (r01)
Kujaku Ou 2 - Geneijou (J)	孔雀王2(日)
Kuuga - Operation Code 'Vapor Trail' (J)	空牙(日)
Kyuukai Douchuuki Baseball (J)	球界道中记(日)
Kyuukyoku Tiger (J)	究级虎(日)
La Russa 95 (JUE)
Labyrinth of Death (J)
Lakers vs Celtics (U)	NBA湖人Vs 凯尔特人(美)
Landstalker - Die Schatze von Konig Nolo (G)	秘境魔宝(德)
Landstalker - Koutei no Zaihou (J)	秘境魔宝(日)
Landstalker - Le Tresor du Roi Nole (F)	秘境魔宝(法)
Landstalker - The Treasures of King Nole (Beta)	秘境魔宝(测试版)
Landstalker - The Treasures of King Nole (E)	秘境魔宝(欧)
Landstalker - The Treasures of King Nole (U)	秘境魔宝(美)
Langrisser (J)	梦幻模拟战(日)
Langrisser II (J) (r00)	梦幻模拟战2(r00)(日)
Langrisser II (J) (r01)	梦幻模拟战2(r01)(日)
Langrisser II (J) (r02)	梦幻模拟战2(r02)(日)
Last Action Hero (JUE)	最后魔鬼英雄(日美欧)
Last Battle - Legend of the Final Hero (U)	北斗神拳(美)
Lawnmower Man, The (JUE)	除魔战士(日美欧)
Legend of Galahad, The (U)	亚瑟王(美)
Lemmings (E)	旅鼠总动员(欧)
Lemmings (JU) (r00)	旅鼠总动员(r00)(日美)
Lemmings (JU) (r01)	旅鼠总动员(r01)(日美)
Lemmings 2 - The Tribes (E)	旅鼠总动员2(欧)
Lemmings 2 - The Tribes (U)	旅鼠总动员2(美)
Lethal Enforcers (E)	致命杀手1(欧)
Lethal Enforcers (J)	致命杀手1(日)
Lethal Enforcers (U)	致命杀手1(美)
Lethal Enforcers II - Gun Fighters (E)	致命杀手2(欧)
Lethal Enforcers II - Gun Fighters (JU)	致命杀手2(日美)
LHX Attack Helicopter (J)	武装直升机(日)
LHX Attack Helicopter (U)	武装直升机(美)
Liberty or Death (U)	独立战争(美)
Light Crusader (E) (M4)	光之十字军战士(欧)
Light Crusader (JE)	光之十字军战士(日欧)
Light Crusader (K)	光之十字军战士(韩)
Light Crusader (U)	光之十字军战士(美)
Lightening Force (U)	闪电出击特别版(美)
Link Dragon (Unl)	接龙(Unl)
Lion King, The (JUE)	狮子王(日美欧)
Lord Monarch - Tokoton Sentou Densetsu (J)	战斗传说(日)
Lost Vikings, The (E) [a1]	失落的维京人[a1](欧)
Lost Vikings, The (E)	失落的维京人(欧)
Lost Vikings, The (U)	失落的维京人(美)
Lotus II RECS (Beta)	莲花赛车2(测试版)
Lotus II RECS (JUE)	莲花赛车2(日美欧)
Lotus Turbo Challenge (JUE)	莲花赛车-超速挑战(日美欧)
M.U.S.H.A. - Metallic Uniframe Super Hybrid Armor (U)	变形战机(美)
Madden NFL 95 (JUE)	约翰麦登橄榄球95(日美欧)
Madden NFL 96 (JUE)	约翰麦登橄榄球96(日美欧)
Madden NFL 97 (JUE)	约翰麦登橄榄球97(日美欧)
Madden NFL 98 (JUE)	约翰麦登橄榄球98(日美欧)
Madou Monogatari I (J)	魔导物语(日)
Magic Girl (Ch) (Unl)	魔术女孩(中)
Magic School Bus, The (U)	魔术校车(美)
Magical Hat no Buttobi Turbo! Daibouken (J)
Magical Taruruuto-kun (J)
Mahjong Cop Ryuu - Shiro Ookami no Yabou (J)	麻将龙-白狼的野望(日)
Mamono Hunter Youko - Dai 7 no Keishou (J)	魔界猎人妖子(日)
Maou Renjishi (J)	魔王连狮子(日)
Marble Madness (U)	疯狂小球(美)
Mario Andretti Racing (JUE)	马里奥赛车(日美欧)
Mario Lemieux Hockey (U)	马里奥曲棍球(美)
Marko's Magic Football (Beta) (M4)	马可的魔法足球(测试版)
Marko's Magic Football (E) (M4)	马可的魔法足球(欧)
Marko's Magic Football (U)	马可的魔法足球(美)
Marsupilami (E) (M5)	马苏皮啦米(欧)
Marsupilami (U) (M5)	马苏皮啦米(美)
Marvel Land (J)	奇异岛(日)
Marvel Land (U)	奇异岛(美)
Mary Shelley's Frankenstein (U)	玛丽与雪莱(美)
Master of Monsters (J)	主人的怪物(日)
Master of Monsters (U)	主人的怪物(美)
Master of Weapon (U)	支配战机(美)
Maten no Soumetsu (J)	魔天的创灭(日)
Math Blaster - Episode 1 (U)	数字射击(美)
Mazin Saga (J) [a1]	Mazin传说[a1](日)
Mazin Saga (J)	Mazin传说(日)
Mazin Saga (U)	Mazin传说(美)
Mazin Wars (E)	铁甲万能侠(欧)
McDonald's Treasure Land Adventure (E)	麦当劳叔叔的黄金岛冒险(欧)
McDonald's Treasure Land Adventure (J)	麦当劳叔叔的黄金岛冒险(日)
McDonald's Treasure Land Adventure (U)	麦当劳叔叔的黄金岛冒险(美)
Mega Anser (J)	演示程序(日)
Mega Bomberman - 8 Player Demo (JUE)	炸弹人(日美欧)
Mega Bomberman (JUE)	炸弹人(日美欧)
Mega Bomberman (JUE)	炸弹人(日美欧)
Mega Games 10 (E)
Mega Games 2 (E)
Mega Games 3 (E)
Mega Games 6 (E)
Mega Games 6 Vol
Mega Games I (E)
Mega Lo Mania (E) (r00)	海上争雄(r00)(欧)
Mega Lo Mania (E) (r01)	海上争雄(r01)(欧)
Mega Lo Mania (J)	海上争雄(日)
Mega SWIV (E)	威虎战机(欧)
Mega Turrican (E)	Mega银河战士(欧)
Mega Turrican (U)	Mega银河战士(美)
Megaman - The Wily Wars (E)	洛克人123(欧)
Megapanel (J)	拼图方块(日)
MegaTraX (J)	小型赛车挑战赛(日)
Mercs (JUE)	战场之狼(日美欧)
Metal Fangs (J)	金属狼(日)
Metal Head (32X) (E)	金属领袖战士(32X)(欧)
Metal Head (32X) (JU)	金属领袖战士(32X)(日美)
Michael Jackson's Moonwalker (J) (r00)	外星战将(日)
Michael Jackson's Moonwalker (UE) (r01)	外星战将(美欧)
Mick & Mack as the Global Gladiators (Beta)	橡胶枪(测试版)
Mick & Mack as the Global Gladiators (E)	橡胶枪(欧)
Mick & Mack as the Global Gladiators (U)	橡胶枪(美)
Mickey Mania - The Timeless Adventures of Mickey Mouse (Beta)	疯狂米老鼠(测试版)
Mickey Mania - The Timeless Adventures of Mickey Mouse (E)	疯狂米老鼠(欧)
Mickey Mania - The Timeless Adventures of Mickey Mouse (U)	疯狂米老鼠(美)
Mickey's Ultimate Challenge (U)	米老鼠终极挑战(美)
Micro Machines (E) [a1][c]	微型机器[a1][c](欧)
Micro Machines (E) [a2][x]	微型机器[a2][x](欧)
Micro Machines (E)	微型机器(欧)
Micro Machines (U)	微型机器(美)
Micro Machines 2 - Turbo Tournament (JUE) (J-Cart)	微型机器2(J-Cart)(日美欧)
Micro Machines 2 - Turbo Tournament (JUE)	微型机器2(日美欧)
Micro Machines '96 (V1.1) (E) (J-Cart)	微型机器96(J-Cart)(欧)
Micro Machines '96 (V1.1) (E)	微型机器96(欧)
Micro Machines Military - It's a Blast! (E) (J-Cart)	微型机器军事版(J-Cart)(欧)
Micro Machines Military - It's a Blast! (E) [x]	微型机器军事版(欧)
Midnight Resistance (J)	魂斗罗(日)
Midnight Resistance (U)	魂斗罗(美)
Mig-29 Fulcrum (E)	米格29(欧)
Mig-29 Fulcrum (U)	米格29(美)
Might and Magic - Gates to Another World (U) (r01)	魔法门(美)
Might and Magic III - Isles of Terra (U) [x]	魔法门3(美)
Mighty Max (E)	万能麦斯(欧)
Mighty Max (U)	万能麦斯(美)
Mighty Morphin Power Rangers - The Movie (E)	恐龙战队-电影版(欧)
Mighty Morphin Power Rangers - The Movie (U)	恐龙战队-电影版(美)
Mighty Morphin Power Rangers (E)	恐龙战队(欧)
Mighty Morphin Power Rangers (U)	恐龙战队(美)
Mike Ditka Power Football (U) [a1]	实力橄榄球[a1](美)
Mike Ditka Power Football (U)	实力橄榄球(美)
Minato no Traysia (J)	旅立的剑士(日)
Minnesota Fats Pool Legend (JUE)	明尼苏达的胖子--台球(日美欧)
Miracle Piano Teaching System (U)	钢琴教学(美)
Misadventures of Flink, The (E)	弗林克的冒险(欧)
MLBPA Baseball (JUE)	棒球(日美欧)
MLBPA Sports Talk Baseball (U)	棒球(美)
Monica na Terra dos Monstros (B)
Monopoly (Beta)	大富翁(测试版)
Monopoly (U)	大富翁(美)
Monster World III - Wonder Boy V (J)	冒险世界3(日)
Monster World IV (J)	冒险世界4(日)
Mortal Kombat (JUE) (r00)	致命格斗(日美欧)
Mortal Kombat (JUE) (r01) (Prototype)	致命格斗(工程版)(日美欧)
Mortal Kombat 3 (E)	致命格斗3(欧)
Mortal Kombat 3 (U)	致命格斗3(美)
Mortal Kombat II (32X) (JUE) (Dec 1994)	致命格斗2'94(32X)(日美欧)
Mortal Kombat II (32X) (JUE) (Jan 1995)	致命格斗2'95(32X)(日美欧)
Mortal Kombat II (JUE)	致命格斗2(日美欧)
Motocross Championship (32X) (E)	摩托车越野赛(32X)(欧)
Motocross Championship (32X) (JU)	摩托车越野赛(32X)(日美)
Mr. Nutz (E)	松鼠鲁兹(欧)
Ms. Pac-Man (U)	吃豆子(美)
Mugen Senshi Valis (J)
Muhammad Ali Heavyweight Boxing (Beta)	穆罕默德阿里拳击(测试版)
Muhammad Ali Heavyweight Boxing (E)	穆罕默德阿里拳击(欧)
Muhammad Ali Heavyweight Boxing (U)	穆罕默德阿里拳击(美)
Mulan (Ch) (Unl)	花木兰(中)
Multitap - IO Sample Program of Nov 28 1992 (JUE)	样本程序(日美欧)
Musha Aleste - Fullmetal Fighter Ellinor (J)
Mutant League Football (J)	木乃伊美式足球(日)
Mutant League Football (U)	木乃伊美式足球(美)
Mutant League Hockey (JUE)	木乃伊曲棍球(日美欧)
Mystic Defender (JUE) (r00)	孔雀王2(r00)(日美欧)
Mystic Defender (JUE) (r01)	孔雀王2(r01)(日美欧)
Mystical Fighter (U)	魔王连狮子(美)
Nakajima Satoru's F1 Grand Prix (J)
Nakajima Satoru's F1 Hero MD (J)
Nakajima Satoru's F1 Super License (J)
NBA Action (U)	动作NBA(美)
NBA Action 95 (JUE)	动作NBA95(美)
NBA All-Star Challenge (U)	NBA全明星挑战赛(美)
NBA Hang Time (E)	NBA二对二斗牛(欧)
NBA Hang Time (U)	NBA二对二斗牛(美)
NBA Jam (JUE) (r00)	NBA灌蓝(日美欧)
NBA Jam (UE) (r01)	NBA灌蓝(美欧)
NBA Jam Tournament Edition (32X) (JUE)000	NBA灌蓝秀(32X)(日美欧)
NBA Jam Tournament Edition (JUE) (r00)000	NBA灌蓝秀(r00)(日美欧)
NBA Jam Tournament Edition (JUE) (r01)000	NBA灌蓝秀(r01)(日美欧)
NBA Live 95 (JUE)	NBA95(日美欧)
NBA Live 96 (JUE)	NBA96(日美欧)
NBA Live 97 (JUE)	NBA97(日美欧)
NBA Live 98 (JUE)	NBA98(日美欧)
NBA Pro Basketball - Bulls vs Lakers (J)	NBA篮球公牛VS湖人(日)
NBA Pro Basketball '94 (J)	NBA篮球94(日)
NBA Showdown 94 (Beta)	NBA灌篮赛94(测试版)
NBA Showdown 94 (UE)	NBA灌篮赛94(美欧)
NCAA College Football (U)	美国大学生橄榄球(美)
NCAA Final Four College Basketball (U)	美国大学生篮球(美)
Nekketsu Koukou Dodgeball Bu MD Soccer Hen (J)	热血足球(日)
New 3D Golf Simulation Pebble Beach no Hatou (J)
New 3D Golf Simulation Waialae no Kiseki (J)
New Zealand Story, The (J)	新西兰岛传说(日)
Newman-Haas Indy Car Racing (JUE)	汽车比赛(日美欧)
NFL '95 (JUE)	NFL95(日美欧)
NFL 98 (U)	NFL98(美)
NFL Football '94 Starring Joe Montana (J)	NFL橄榄球94(日)
NFL Football '94 Starring Joe Montana (U)	NFL橄榄球94(美)
NFL Prime Time (U)	NFL最终时刻(美)
NFL Quarterback Club (32X) (JUE)000	橄榄球俱乐部(32X)(日美欧)
NFL Quarterback Club (JUE)000	橄榄球俱乐部(日美欧)
NFL Quarterback Club 96 (JUE)000	橄榄球俱乐部96(日美欧)
NHL 95 (JUE)	曲棍球赛95(日美欧)
NHL 96 (JUE)	曲棍球赛96(日美欧)
NHL 97 (JUE)	曲棍球赛97(日美欧)
NHL 98 (U)	曲棍球赛98(美)
NHL All-Star Hockey '95 (U)	全明星曲棍球赛95(美)
NHL Hockey (U)	NHL曲棍球(美)
NHL Hockey 94 (JUE)	NHL曲棍球94(日美欧)
NHLPA NHL '93 (U) (r00)	NHL曲棍球93(r00)(美)
NHLPA NHL '93 (U) (r01)	NHL曲棍球93(r01)(美)
Nigel Mansell's World Championship (E)	世界冠军(欧)
Nigel Mansell's World Championship (U)	世界冠军(美)
Nightmare Circus (JUE) [x]	波斯王子(日美欧)
Nikkan Sports Pro Yakyuu Van (J)	日刊野球(日)
Ninja Burai Densetsu (J)	忍者武雷传说(日)
Ninja Gaiden (JUE) [h]	忍者外传(日美欧)
Nippon Pro Mahjong Renmei Kounin Jannou Touryuumon (J) [a1]
Nippon Pro Mahjong Renmei Kounin Jannou Touryuumon (J)
No Escape (U)	义无反顾(美)
Nobunaga no Yabou - Bushou Fuuunroku (J)	信长的野望-武将风云录(日)
Nobunaga no Yabou - Haouden (J)	信长的野望-霸王传(日)
Nobunaga no Yabou - Zenkokuban (J)	信长的野望-全国版(日)
Nobunaga's Ambition (U)
Normy's Beach Babe-O-Rama (JUE)	海滩宝贝(日美欧)
Olympic Gold - Barcelona '92 (E)	92巴塞罗那奥运会(欧)
Olympic Gold - Barcelona '92 (J)	92巴塞罗那奥运会(日)
Olympic Gold - Barcelona '92 (U) [a1][c]	92巴塞罗那奥运会[a1][c](美)
Olympic Gold - Barcelona '92 (U)	92巴塞罗那奥运会(美)
Olympic Summer Games Atlanta 96 (JUE)	96亚特兰大夏季奥运(日美欧)
Olympic Winter Games - Lillehammer 1994 (J)	94冬季奥运(日)
Olympic Winter Games - Lillehammer 1994 (U) [x]	94冬季奥运(美)
Omega Race (J) [x]	旋转战机(日)
Onslaught (Unl)	突击(Unl)
Ooze, The (E)	毒液(欧)
Ooze, The (JU)	毒液(日美)
Operation Europe - Path to Victory 1939-45 (U)	第二次世界大战(美)
Osomatsu-kun - Hachamecha Gekijou (J) [x]
Ottifants, The (E)	玩具(欧)
Ottifants, The (G) (Beta)	玩具(测试版)(德)
Out of this World (U)	另一个世界(美)
Outlander (E)	主视点赛车(欧)
Outlander (U)	主视点赛车(美)
OutRun (JUE) [a1]	户外大飙车[a1](日美欧)
OutRun (JUE)	户外大飙车(日美欧)
OutRun 2019 (E)	户外大飙车-2019未来版(欧)
OutRun 2019 (J)	户外大飙车-2019未来版(日)
OutRun 2019 (U) (Beta)	户外大飙车-2019未来版(测试版)(美)
OutRun 2019 (U)	户外大飙车-2019未来版(美)
OutRunners (J)	户外大飙车-街机版(日)
OutRunners (U)	户外大飙车-街机版(美)
Ozaki Naomichi's Super Masters (J)
Pac-Attack (U)	小精灵方块(美)
Pachinko Kuunyan (J)
Pacific Theater of Operations (U)	激战太平洋(美)
Pac-Man 2 - The New Adventures (U)	小精灵2-新的冒险(美)
Pac-Mania (U)	小精灵-立体版(美)
Paddle Fighter (J) (Sega Channel)
Pagemaster, The (Beta)	卡通大圣(测试版)
Pagemaster, The (E)	卡通大圣(欧)
Pagemaster, The (U)	卡通大圣(美)
Panorama Cotton (J) [x]	小魔女科顿(日)
Panzer Commander (J) [a1]	骑士传说[a1](日)
Panzer Commander (J)	骑士传说(日)
Paperboy (J)	送报童(日)
Paperboy (UE)	送报童(美欧)
Paperboy II (U)	送报童2(美)
Party Quiz Mega Q (J)
Pat Riley Basketball (U)	派特瑞里篮球(美)
Patlabor - 98shiki Kidou Seyo! (J) [x]
Pebble Beach Golf Links (E)	培柏海岸高尔夫球场(欧)
Pebble Beach Golf Links (U)	培柏海岸高尔夫球场(美)
Pele! (JUE)	贝利足球(日美欧)
Pele's World Tournament Soccer (JUE)	贝利足球2(日美欧)
Pengo (J)	小企鹅(日)
Pete Sampras Tennis (JUE) (J-Cart)	桑普拉斯网球赛(J-Cart)(日美欧)
Pete Sampras Tennis (JUE) [x]	桑普拉斯网球赛[x](日美欧)
Pete Sampras Tennis '96 (E)	桑普拉斯网球赛(欧)
PGA European Tour (JUE)	欧洲职业高尔夫球赛(日美欧)
PGA Tour 96 (JUE)	职业高尔夫球赛96(日美欧)
PGA Tour Golf (U) (r01)	职业高尔夫巡回赛(r01)(美)
PGA Tour Golf (U) (r02)	职业高尔夫巡回赛(r02)(美)
PGA Tour Golf II (J)	职业高尔夫球赛2(日)
PGA Tour Golf II (JUE) (r00)	职业高尔夫球赛2(r00)(日美欧)
PGA Tour Golf II (JUE) (r01)	职业高尔夫球赛2(r01)(日美欧)
PGA Tour Golf III (JUE)	职业高尔夫球赛3(日美欧)
Phantasy Star - The End of the Millennium (J)	梦幻之星(日)
Phantasy Star - The End of the Millennium (U)	梦幻之星(美)
Phantasy Star II - Anne's Adventure (J) (Sega Channel)	梦幻之星2-安妮
Phantasy Star II - Huey's Adventure (J) (Sega Channel)	梦幻之星2
Phantasy Star II - Kinds's Adventure (J) (Sega Channel)	梦幻之星2-肯德斯
Phantasy Star II - Shilka's Adventure (J) (Sega Channel)	梦幻之星2-希尔卡
Phantasy Star II (B) (r01)	梦幻之星2(r01)(B)
Phantasy Star II (J) [x]	梦幻之星2(日)
Phantasy Star II (UE) (r01) [a1]	梦幻之星2(r01)[a1](美欧)
Phantasy Star II (UE) (r01)	梦幻之星2(r01)(美欧)
Phantasy Star II (UE) (r02)	梦幻之星2(r02)(美欧)
Phantasy Star III - Generations of Doom (B)	梦幻之星3(B)
Phantasy Star III - Generations of Doom (UE)	梦幻之星3(美欧)
Phantasy Star III - Toki no Keishousha (J)	梦幻之星3(日)
Phantom 2040 (E)	幻影2040(欧)
Phantom 2040 (U)	幻影2040(美)
Phelios (E)	飞马骑士(纵)(欧)
Phelios (J)	飞马骑士(纵)(日)
Phelios (U)	飞马骑士(纵)(美)
Pink Goes to Hollywood (U)	粉色好莱坞(美)
Pinocchio (E)	木偶奇遇记(欧)
Pinocchio (U)	木偶奇遇记(美)
Pirates of Dark Water, The (E) (May 1994)
Pirates of Dark Water, The (U) (Jan 1994)
Pirates! Gold (Beta)	海盗的宝藏(测试版)
Pirates! Gold (U)	海盗的宝藏(美)
Pit Fighter (Beta)	自由博击(测试版)
Pit Fighter (JUE)	自由博击(日美欧)
Pitfall - The Mayan Adventure (32X) (U)	陷阱-玛雅冒险(32x)(美)
Pitfall - The Mayan Adventure (E)	陷阱-玛雅冒险(32x)(欧)
Pitfall - The Mayan Adventure (U)	陷阱-玛雅冒险(美)
Pocahontas (U)	风中奇缘(美)
Pocket Monsters 2 (Unl)	口袋妖怪2(Unl)
Populous (E)	部落(欧)
Populous (U) [a1]	部落[a1](美)
Populous (U)	部落(美)
Populous II - Two Tribes (E)	部落2(欧)
Populous II - Wrath of the Gods (U)	部落2(美)
Power Athlete (J)	力量选手(日)
Power Drive (JUE) (M5)	动力赛车(日美欧)
Power Monger (J)	传播力量(日)
Power Monger (U)	传播力量(美)
Powerball (U)	超能力球赛(美)
Predator 2 (JUE)	掠夺者2(日美欧)
Premier Manager (E)	首席经理(欧)
Premier Manager 97 (E)	首席经理97(欧)
Pretty Girl Mahjong (Ch) (Unl) [x]	究级麻将(中)
Primal Rage (32X) (JUE)	原始动物疯狂格斗(32X)(日美欧)
Primal Rage (JUE)	原始动物疯狂格斗(日美欧)
Prince of Persia (Beta 1)	波斯王子(测试版 1)
Prince of Persia (Beta 2)	波斯王子(测试版 2)
Prince of Persia (E)	波斯王子(欧)
Prince of Persia (U)	波斯王子(美)
Pro Quarterback (U)	橄榄球(美)
Pro Yakyuu Super League 91 (J)
Probotector (E)	欧版魂斗罗(欧)
Psycho Pinball (Beta) (M5)	弹球(Beta)
Psycho Pinball (JUE) (M5)	弹球(日美欧)
Psy-O-Blade Moving Adventure (J)	飞行历险(日)
Puggsy (Beta)	海岛冒险(测试版)
Puggsy (E)	海岛冒险(欧)
Puggsy (U)	海岛冒险(美)
Pulseman (J)	脉冲超人(日)
Punisher, The (E)	惩罚者(欧)
Punisher, The (U)	惩罚者(美)
Putter Golf (J) (Sega Channel)	迷你高尔夫(Sega Channel)(日)
Puyo Puyo (J)	魔法气泡(日)
Puyo Puyo 2 (J) (r00)	魔法气泡2(r00)(日)
Puyo Puyo 2 (J) (r01)	魔法气泡2(r01)(日)
Puzzle & Action - Ichidant (J)	游戏大挑战1(日)
Puzzle & Action - Tanto-R (J)	游戏大挑战2(日)
Pyramid Magic (J) (Sega Channel)	神秘金字塔(Sega Channel)(日)
Pyramid Magic II (J) (Sega Channel)	神秘金字塔2(Sega Channel)(日)
Pyramid Magic III (J) (Sega Channel)	神秘金字塔3(Sega Channel)(日)
Quack Shot Starring Donald Duck (JUE) (r00)	打鸭子(r00)(日美欧)
Quack Shot Starring Donald Duck (JUE) (r01)	打鸭子(r01)(日美欧)
Quad Challenge (U)	小型赛车挑战(美)
Race Drivin' (JUE)	3D赛车(日美欧)
Radical Rex (E)	雷克斯龙(欧)
Radical Rex (U)	雷克斯龙(美)
Raiden Trad (JUE)	雷电(日美欧)
Rainbow Islands - The Story of Bubble Bobble 2 (JUE)	彩虹岛(日美欧)
Rambo III (J) (r00)	蓝博3(日)
Rambo III (UE) (r01)	蓝博3(美欧)
Rampart (JUE)	堡垒(日美欧)
Ranger-X (E)	机器勇士(欧)
Ranger-X (U)	机器勇士(美)
Ransei no Hasha (J)	乱世的霸者(日)
Rastan Saga II (J)	神剑传说2 (日)
Rastan Saga II (U)	神剑传说2 (美)
RBI Baseball 3 (JUE)	打点棒球3(日美欧)
RBI Baseball 4 (JUE) (Aug 1991) [x]	打点棒球4(日美欧)[1991]
RBI Baseball 4 (JUE) (Jun 1992)	打点棒球4(日美欧)[1992]
RBI Baseball 93 (JUE)	打点棒球93 (日美欧)
RBI Baseball 94 (JUE)	打点棒球94 (日美欧)
RBI Baseball '95 (32X) (U)	打点棒球95(32X)(美)
Red Zone (JUE)	红色地带 (日美欧)
Ren and Stimpy's Invention (E)	兔兔历险记(欧)
Ren and Stimpy's Invention (U)	兔兔历险记(美)
Rent a Hero (J)	英雄(日)
Resq (E) [x]	卡通飞行器(欧)
Revenge of Fu Manchu, The (Beta)	僵尸复仇(测试版)
Revenge of Shinobi, The (E) (r02)	超级忍(欧)(R02)
Revenge of Shinobi, The (E) (r03)	超级忍(欧)(R03)
Revenge of Shinobi, The (JU) (r00)	超级忍(日欧)
Revenge of Shinobi, The (U) (r01)	超级忍(美)
Revolution X (JUE)	X革命(日美欧)
Richard Scarry's BusyTown (U)	理查德快乐城市(美)
Rings of Power (U)	魔力指环(美)
Rise of the Robots (JUE)	机器人格斗(日美欧)
Risk (U)	十字军东征(美)
Risky Woods (UE)	屠魔大法师(美欧)
Ristar - The Shooting Star (J)	外星王子(日)
Ristar (UE)	外星王子(美欧)
Road Blasters (JUE) (Jul 1991)	疾风赛车 (7月1991)(日美欧)
Road Blasters (JUE) (Oct 1991)	疾风赛车 (10月1991)(日美欧)
Road Rash (U)	暴力摩托(美)
Road Rash 3 (JUE)	暴力摩托3(日美欧)
Road Rash II (J) (r00)	暴力摩托2(日)
Road Rash II (UE) (r02)	暴力摩托2(美欧)
Road Rash II (UE) (rXX)	暴力摩托2(美欧)
Robocop 3 (JUE)	机器战警3(日美欧)
Robocop vs The Terminator (Beta 1)	机器战警对终结者(测试版 1)
Robocop vs The Terminator (Beta 2)	机器战警对终结者(测试版 2)
Robocop vs The Terminator (E)	机器战警对终结者(欧)
Robocop vs The Terminator (U)	机器战警对终结者(美)
Rock n' Roll Racing (E)	滚轮比赛(欧)
Rock n' Roll Racing (U)	滚轮比赛(美)
Rocket Knight Adventures (E)	火箭骑士历险记(欧)
Rocket Knight Adventures (J)	火箭骑士历险记(日)
Rocket Knight Adventures (U)	火箭骑士历险记(美)
Rockman Megaworld (J) [a1]	洛克人(日)
Rockman Megaworld (J)	洛克人(日)
Rocky and Bullwinkle and Friends, The Adventures of (U)
Roger Clements MVP Baseball (U)	罗杰克林明星棒球(美)
Rolling Thunder 2 (E)	轰天雷2(欧)
Rolling Thunder 2 (J)	轰天雷2(日)
Rolling Thunder 2 (U)	轰天雷2(美)
Rolling Thunder 3 (U)	轰天雷3(美)
Rolo to the Rescue (J)	小象露露历险记(日)
Rolo to the Rescue (UE)	小象露露历险记(欧美)
Romance of the Three Kingdoms II (U)	三国志2(美)
Romance of the Three Kingdoms III (U)	三国志3(美)
Ronaldinho 98 (JUE)	98足球(日美欧)
Royal Blood (J)	皇家血统(日)
Rugby World Cup 1995 (JUE) (M3)	鲁格比世界足球95(日美欧)
Runark (J)	鳄鱼先生(日)
Ryuuko no Ken (J)
Sagaia (U)	太空战斗机(美)
Saint Sword (J)	圣剑(日)
Saint Sword (U)	圣剑(美)
Same! Same! Same! (J)
Samurai Shodown (E)	侍魂(欧)
Samurai Shodown (U)	侍魂(美)
Samurai Spirits (J)	侍魂(日)
Sangokushi II (J)	三国志2(日)
Sangokushi III (J)	三国志3(日)
Sangokushi IV (32X) (J)	三国志4(32X)(日)
Sangokushi Retsuden - Ransei no Eiyuutachi (J)	三国志列传-乱世群英(日)
Sangokushi Retsuden (Ch)	三国志列传-乱世群英(中)
Sangokushi V (Ch) (Unl) [x]	三国志5(中)
Saturday Night Slammasters (E)	摔跤霸王(欧)
Saturday Night Slammasters (U)	摔跤霸王(美)
Scooby Doo Mystery (JUE)	鬼屋(日美欧)
Scrabble (E) [x]	拼图游戏(欧)
SeaQuest DSV (E)	海之传说(欧)
SeaQuest DSV (U)	海之传说(美)
Second Samurai, The (E)	武士魂(欧)
Sega Channel (JUE)	SEGA声明(日美欧)
Sega Sports 1 (E)	SEGA体育3合1(欧)
Sega Top Five (B)
Sensible Soccer - International Edition (E) (M4)	足球经理国际版(欧)
Sensible Soccer (E) (M4)	足球经理(欧)
Sesame Street Counting Cafe (U)	芝麻街-咖啡屋(美)
Shadow Blasters (U)	四天明王(美)
Shadow Dancer - The Secret of Shinobi (JUE)	影武者-忍者之秘 (日美欧)
Shadow of the Beast (J)	兽之影(日)
Shadow of the Beast (UE)	兽之影(欧美)
Shadow of the Beast II (U)	兽之影2(美)
Shadowrun (J)	暗之追迹者(日)
Shadowrun (U)	暗之追迹者(美)
Shane Warne Cricket (E)	薛耐板球(欧)
Shanghai II - Dragon's Eye (Beta)	上海2(测试版)
Shanghai II - Dragon's Eye (U)	上海2(美)
Shaq Fu (JUE)	夏福(日美欧)
Shijou Saidai no Soukoban (J)
Shikinjou (J)
Shin Changsegi - Ragnacenty