1941 - Counter Attack (Super Grafx) (J) [a]
1941 - Counter Attack (Super Grafx) (J)
1943 Kai (J)	1943改版(日)
21 Emon - Mezase Hotel Ou!! (J)	旅馆王(日)
Adventure Island (J)	神奇男孩(日)
Aero Blasters (J)	空战克星(日)
Aero Blasters (U)	空战克星(美)
After Burner II (J)	冲破火网２(日)
Air Zonk (U)	空中射击(美)
Aldynes (Super Grafx) (J)	霹雳风云(日)
Alien Crush (J)	异形弹珠台(日)
Alien Crush (U)	异形弹珠台(美)
Ankoku Densetsu (J)	暗黑传说(日)
Aoi Blink (J)	青色杜马(日)
Appare Gateball (J)	槌球大赛(日)
Armed Formation F (J)	F武装战机(日)
Artist Tool (J)	绘图工具(日)
Atomic Robo-Kid Special (J)	原子机械童(日)
AV Poker (J)	AV扑克(日)
Ballistix (J)	妖魔传(日)
Ballistix (U)	妖魔传(美)
Bari Bari Densetsu (J)	妖魔传(美)
Barunba (J)	宝伦大作战(日)
Batman (J)	蝙蝠侠(日)
Battle Ace (Super Grafx) (J)	空中火狐(日)
Battle Lode Runner (J)
Battle Royale (U)
Be Ball (J)	太极球(日)
Benkei Gaiden (J) [a]	牟庆外传(日)[a]
Benkei Gaiden (J)	牟庆外传(日)
Bikkuriman World (J) [a]
Bikkuriman World (J)
Blazing Lazers (U)	燃烧空战(美)
Blodia (J)	迷魂阵(日)
Bloody Wolf (U)	血狼(美)
Body Conquest II (J)	美女外传2(日)
Bomberman - Users Battle (J)	轰炸超人(日)
Bomberman (J)	轰炸超人(日)
Bomberman (U)	轰炸超人(美)
Bomberman '93 (J)	轰炸超人 '93(日)
Bomberman '93 (Special Version) (J)	轰炸超人 '93(日)
Bomberman '93 (U)	轰炸超人 '93(美)
Bomberman '94 (J)	轰炸超人 '94(日)
Bonk III - Bonk's Big Adventure (U)	PC原人大冒险(美)
Bonk's Adventure (U)	PC原人冒险记(美)
Bonk's Revenge (U)	PC原人复仇记(美)
Bouken Danshaku Don - The Lost Sunheart (J)	冒险男爵(日)
Boxyboy (U)	仓库番(美)
Bravoman (U)	超绝伦人(美)
Break In (J)	花式撞球(日)
Bubblegum Crash! - Knight Sabers 2034 (J)	吹波糖危机(日)
Bull Fight - Ring no Haja (J)	拳王争霸 (日)
Burning Angels (J)	燃烧天使(日)
Busou Keiji - Cyber Cross (J)	武装刑事(日)
[CD] Games Express CD Card (J)
Cadash (J)	卡达叙传说(日)
Cadash (U)	卡达叙传说(美)
Champion Wrestler (J)	疯狂摔角(日)
Champions Forever Boxing (U)	霸王拳击(美)
Chew Man Fu (U)	太极球(美)
Chibi Maruko Chan - Quiz de Piihyara (J)	小丸子机智问答(日)
Chikudenya Toubei - Kubikiri Yakata Yori (J) [a]	逐电屋藤兵卫(日)[a]
Chikudenya Toubei - Kubikiri Yakata Yori (J)	逐电屋藤兵卫(日)
China Warrior (U)	中国功夫--李小龙(美)
Chouzetsu Rinjin - Bravoman (J)
Circus Lido (J)	泡泡虫(日)
City Hunter (J)	城市猎人(日)
Columns (J)	宝石方块(日)
Coryoon - Child of Dragon (J) [a]	顽皮龙(日)[a]
Coryoon - Child of Dragon (J)	顽皮龙(日)
Cratermaze (U)
Cross Wiber - Cyber Combat Police (J)	武装战斗刑事(日)
Cyber Core (J)	战斗生命体(日)
Cyber Core (U)	战斗生命体(美)
Cyber Dodge (J)	战斗躲避球(日)
Cyber Knight (J)	武装骑士(日)
Dai Makaimura (Super Grafx) (J)	大魔界村(日)
Dai Senpu (J)
Daichi Kun Crisis - Do Natural (J)	幻之大地(日)
Darius Alpha (J)	太空战机Alpha(日)
Darius Plus (Super Grafx-compatible) (J)	太空战机Plus(日)
Darkwing Duck (U)	怪鸭历险记(美)
Davis Cup Tennis (U)	戴维斯杯网球(美)
Dead Moon (J)	死亡之月(日)
Dead Moon (U)	死亡之月(美)
Deep Blue - Kaitei Shinwa (J)	海底神话(日)
Deep Blue (U)	海底神话(美)
Detana!! TwinBee (J)	兵蜂 (日)
Devil Crash - Naxat Pinball (J)	魔幻弹珠台(日)
Devil's Crush - Naxat Pinball (U)	魔幻弹珠台(美)
Die Hard (J)	终极警探(日)
Digital Champ (J)	真实拳击(日)
Don Doko Don! (J)	木匠兄弟(日)
Doraemon - Meikyuu Dai Sakusen (J)	小叮当迷宫大作战(日)
Doraemon - Nobita no Dorabian Night (J)	小叮当阿拉伯之夜(日)
Double Dungeons - W (J)	W双龙战记(日)
Double Dungeons - W (U)	W双龙战记(美)
Download (J) [a]	计算机骑士(日)[a]
Download (J)	计算机骑士(日)
Dragon Egg! (J)	恐龙女战士(日)
Dragon Saber - After Story of Dragon Spirit (J) [a]	龙骑兵(日)[a]
Dragon Saber - After Story of Dragon Spirit (J)	龙骑兵(日)
Dragon Spirit (J)	龙魂(日)
Dragon Spirit (U)	龙魂(美)
Dragon's Curse (U)	龙之咒(美)
Drop Rock Hora Hora (J) [a]	打水果(日)[a]
Drop Rock Hora Hora (J)	打水果(日)
Drop.Off (U)	水果方块(美)
Dungeon Explorer (J)	魔洞战记(日)
Dungeon Explorer (U)	魔洞战记(美)
Energy (J)	艾吉娜(日)
F1 Circus (J) [a]	F1竞技场(日)[a]
F1 Circus (J)	F1竞技场(日)
F1 Circus '91 - World Championship (J)	F1竞技场 '91(日)
F1 Circus '92 - The Speed of Sound (J)	F1竞技场 '92(日)
F-1 Dream (J)	F1之梦(日)
F-1 Pilot - You're King of Kings (J)	F1?#123;驶员(日)
F1 Triple Battle (J)	F1大赛车(日)
Falcon (U)	鹰式战机(美)
Fantasy Zone (J)	幻想空间(日)
Fantasy Zone (U)	幻想空间(美)
Fighting Run (J)	铁甲威龙(日)
Final Blaster (J)	凤凰战机(日)
Final Lap Twin (J)	终极赛车(日)
Final Lap Twin (U)	终极赛车(美)
Final Match Tennis (J)	终极网球(日)
Final Soldier (J)	最终战机(日)
Final Soldier (Special Version) (J)	最终战机限时版(日)
Fire Pro Wrestling - Combination Tag (J)	热血摔角(日)
Fire Pro Wrestling 2 - 2nd Bout (J)	热血摔角2(日)
Fire Pro Wrestling 3 - Legend Bout (J)	热血摔角3(日)
Formation Soccer - Human Cup '90 (J)	休曼杯足球 '90(日)
Formation Soccer - On J. League (J)	休曼J联盟足球(日)
Fushigi no Yume no Alice (J)
Gai Flame (J)	炎之大地(日)
Gaia no Monshou (J)	大地纹章(日)
Galaga '88 (J)	小蜜蜂 '88(日)
Galaga '90 (U)	小蜜蜂 '90(美)
Ganbare! Golf Boys (J)	高尔夫少年(日)
Gekisha Boy (J)
Genji Tsuushin Agedama (J)	通讯少年(日)
Genpei Toumaden (J)	源平讨魔传(日)
Genpei Toumaden Ni no Maki (J)	源平讨魔传(日)
Ghost Manor (U)	幽魂领地(美)
Gokuraku! Chuuka Taisen (J)	中华大仙(日)
Gomola Speed (J)	毛毛虫(日)
Gradius (J)	宇宙巡航舰(日)
Gunboat (U)	激战惩(美)
Gunhed - Hudson Gunhed Taikai (J)	机甲战士特别版(日)
Gunhed (J)	机甲战士(日)
Hana Taaka Daka! (J)	射击天狗
Hanii in the Sky (J)	空中甜心(日)
Hanii on the Road (J)	空中甜心(日)
Hatris (J)	帽子方块(日)
Heavy Unit (J)	机动劲旅(日)
Hisou Kihei - Xserd (J)	飞装骑兵(日)
Hit the Ice - VHL the Official Video Hockey League (J)	冰上曲棍球(日)
Hit the Ice - VHL the Official Video Hockey League (U)	冰上曲棍球(美)
Honoo no Toukyuuji Dodge Danpei (J)	斗球儿弹平(日)
Idol Hanafuda Fan Club (J)	美少女麻雀(日)
Image Fight (J)	幻影战机(日)
Impossamole (U)	浣熊超人(美)
J. League Greatest Eleven (J)	J联盟足球赛(日)
J.J. & Jeff (U)	JJ与杰夫(美)
Jack Nicklaus' Greatest 18 Holes of Major Championship Golf (J)	杰克高尔夫-18洞 (日)
Jack Nicklaus' Turbo Golf (U)	杰克高尔夫-加强版(美)
Jackie Chan (J)	成龙功夫(日)
Jackie Chan's Action Kung Fu (U)	成龙功夫(美)
Jigoku Meguri (J)	Jigoku Meguri(日)
Jinmu Denshou (J) [a]	神武传承(日) [a]
Jinmu Denshou (J)	神武传承(日)
Juuouki (J) [a]	兽王记(日)[a]
Juuouki (J)	兽王记(日)
Kaizou Choujin Shubibinman (J)	改造超人(日)
Kaizou Choujin Shubibinman 2 - Aratanaru Teki (J)	改造超人2(日)
Kato Chan & Ken Chan (J)	爆笑人(日)
Kattobi! Takuhai Kun (J)
Keith Courage in Alpha Zones (U)	希腊斗士基思(魔神英雄传)(美)
KickBall (J)	场式足球(日)
Kiki Kaikai (J)	奇奇怪界(日)
King of Casino (J)	赌场之王(日)
King of Casino (U)	赌场之王(美)
Klax (J)	立体方块(日)
Klax (U)	立体方块(美)
Knight Rider Special (J)	霹雳游侠(日)
Kore ga Pro Yakyuu '89 (J)
Kore ga Pro Yakyuu '90 (J)
Kung Fu, The (J)
Kyuukyoku Mahjong - Idol Graphics (J)	究极麻雀(日)
Kyuukyoku Mahjong II (J)	究极麻雀2(日)
Kyuukyoku Tiger (J)	究极虎(日)
Lady Sword (J) [a]	美少女之剑(日)[a]
Lady Sword (J)	美少女之剑(日)
Legend of Hero Tonma (J)	汤姆历险记(日)
Legend of Hero Tonma (U)	汤姆历险记(美)
Legendary Axe II, The (U)	战斧传说2(美)
Legendary Axe, The (U)	战斧传说(美)
Lode Runner - Lost Labyrinth (J)	矿脉(日)
Madou Ou - Granzooto (Super Grafx) (J)
Maerchen Maze (J)	艾丽斯梦游仙境(日)
Magical Chase (J)	小魔女(日)
Magical Chase (U)	小魔女(美)
Mahjong Gakuen - Touma Soushirou Toujou (J)	麻雀学园东间风四郎(日)
Mahjong Gakuen Mild - Touma Soushirou Toujou (J) [a]	麻雀学园(日)[a]
Mahjong Gakuen Mild - Touma Soushirou Toujou (J)	麻雀学园(日)
Mahjong Gokuu Special (J)	麻雀悟空天竺特别版(日)
Mahjong Haou Den - Kaiser's Quest (J)
Mahjong Shikyaku Retsuden - Mahjong Wars (J)	麻雀战争(日)
Maison Ikkoku (J)
Majin Eiyuu Den Wataru (J)	魔神英雄传(日)
Makai Hakken Den Shada (J)	魔界八犬传(日)
Makai Prince Dorabocchan (J)	魔界王子(日)
Makyou Densetsu (J)	魔境传说(日)
Maniac Puroresu - Asu heno Tatakai (J)
Mesopotamia (J)	弹弓怪(日)
Metal Stoker (J)	铁甲战车(日)
Military Madness (U)	疯狂军队(美)
Mizubaku Dai Bouken (J)
Momotarou Densetsu Gaiden Dai 1 Shuu (J)	桃太郎传说外传(日)
Momotarou Densetsu II (J)	桃太郎传说２(日)
Momotarou Densetsu Turbo (J)	桃太郎传说加强版(日)
Momotarou Katsugeki (J)	桃太郎活剧(日)
Monster Puroresu (J)
Morita Shougi PC (J)	森田将棋(日)
Moto Roader (J)	未来赛车(日)
Moto Roader (U)	未来赛车(美)
Moto Roader II (J) [a]	未来赛车2(日) [a]
Moto Roader II (J)	未来赛车2(日)
Mr. Heli no Daibouken (J) [a]	亨利先生(日) [a]
Mr. Heli no Daibouken (J)	亨利先生(日)
Narazumono Sentai Butai - Bloody Wolf (J)	血腥风暴(日)
Naxat Open (J)	Naxat公开赛(日)
Naxat Stadium (J)	Naxat棒球(日)
Nazo no Mascarade (J)	化妆舞会之谜(日)
Necromancer (J)
Necros no Yousai (J)	尼克罗斯要塞(日)
Nectaris (J)	太空模拟战(日)
Nekketsu Koukou Dodgeball Bu - PC Bangai Hen (J)	热血足球(日)
Nekketsu Koukou Dodgeball Bu - Soccer PC Hen (J)	热血躲避球 (热血高校)(日)
Neutopia (J)	世界冒险记(日)
Neutopia (U)	世界冒险记(美)
Neutopia II (J)	世界冒险记2(日)
Neutopia II (U)	世界冒险记2(美)
New Adventure Island (U)	新冒险岛(美)
New Zealand Story, The (J)	纽西兰故事(日)
NHK Taiga Drama - Taiheiki (J)	NHK太平记(日)
Night Creatures (U)	暗夜生物(美)
Niko Niko Pun (J)	树熊历险记(日)
Ninja Ryuuken Den (J)
Ninja Spirit (U)	最后忍道(美)
Ninja Warriors, The (J)	忍者战士(日)
Obocchama Kun (J)	少爷历险(日)
Operation Wolf (J)	乌兹冲锞(日)
Order of the Griffon (U)	龙与地下城(美)
Ordyne (J)	欧坦救美(日)
Ordyne (U)	欧坦救美(美)
Out Live (J)	疯狂赛车(日)
Out Run (J)	疯狂前进(日)
Override (J)	超空战机(日)
P-47 - The Freedom Fighter (J)	P-47(日)
Pachio Kun - Juuban Shoubu (J)	柏青哥(日)
Pac-Land (J)	小精灵(日)
Pac-Land (U)	小精灵(美)
Panza Kick Boxing (U)
Paranoia (J)	异次元战机(日)
Parasol Stars - The Story of Bubble Bobble III (J)	彩虹岛3(日)
Parasol Stars - The Story of Bubble Bobble III (U)	彩虹岛3(美)
Parodius da! - Shinwa Kara Owarai he (J)
PC Denjin - Punkic Cyborgs (J) [a]	PC原人(日)[a]
PC Denjin - Punkic Cyborgs (J)	PC原人(日)
PC Genjin - Pithecanthropus Computerurus (J) [a]	PC原人(日)[a]
PC Genjin - Pithecanthropus Computerurus (J)	PC原人(日)
PC Genjin 2 - Pithecanthropus Computerurus (J)	PC原人2(日)
PC Genjin 3 - Pithecanthropus Computerurus (J)	PC原人3(日)
PC Genjin 3 - Pithecanthropus Computerurus (Taikenban) (J)	PC原人3(日)
PC Pachi-Slot (J)
Populous (J) [a]	都市计划(日)[a]
Populous (J)	都市计划(日)
Power Drift (J) [a]	超级赛车(日)[a]
Power Drift (J)	超级赛车(日)
Power Eleven (J)	超级足球(日)
Power Gate (J)	超级高尔夫-狭路(日)
Power Golf (J)	超级高尔夫 (日)
Power Golf (U)	超级高尔夫 (美)
Power League (All Star Version) (J)	超级棒球联盟(日)
Power League (J)	超级棒球联盟(日)
Power League '93 (J)	超级棒球联盟 '93 (日)
Power League II (J)	超级棒球联盟2(日)
Power League III (J)	超级棒球联盟3(日)
Power League IV (J)	超级棒球联盟4(日)
Power League V (J)	超级棒球联盟5(日)
Power Sports (J)	超级运动员(日)
Power Tennis (J)	超级网球(日)
Pro Tennis World Court (J)
Pro Yakyuu World Stadium (J)	世界网球(日)
Pro Yakyuu World Stadium '91 (J)	世界网球 '91(日)
Psycho Chaser (J)	闪灵悍将(日)
Psychosis (U)	闪灵悍将(美)
Puzzle Boy (J)	解谜小子(日)
Puzznic (J)	迷魂方块(日)
Quiz Toukou Shashin (J)	写真问答(日)
Rabio Lepus Special (J)	罗比(日)
Racing Damashii (J)
Raiden (J)	雷电(日)
Raiden (U)	雷电(美)
Rastan Saga II (J)	王者之剑2(日)
Rock-On (J)
R-Type (U)
R-Type Part-1 (J)
R-Type Part-2 (J)
Ryukyu (J)	琉球(日)
Sadakichi 7 Series - Hideyoshi no Ougon (J)	秀吉之黄金 (定吉七号)(日)
Saigo no Nindou - Ninja Spirit (J)
Salamander (J)	沙罗曼蛇(日)
Samurai-Ghost (U)	源平讨魔传(美)
Sekigahara (J)	关原之役(日)
Sengoku Mahjong (J)	战国麻雀(日)
Shanghai (J)	上海(日)
Shinobi (J)	忍(日)
Shiryou Sensen (J)	死灵战线 (日)
Shockman (U)	改造超人(美)
Shougi Shodan Icchokusen (J)	将棋-初段一直线(日)
Shougi Shoshinsha Muyou (J)	将棋-初心者无用(日)
SideArms - Hyper Dyne (J)	绝对合体(日)
SideArms - Hyper Dyne (U)	绝对合体(美)
Silent Debuggers (J)	宇宙警备队(日)
Silent Debuggers (U)	宇宙警备队(美)
Sindibad Chitei no Dai Makyuu (J)
Sinistron (U)	激烈战斗(美)
Skweek (J)	毛球历险记(日)
Soldier Blade (J)	太空军鉴(日)
Soldier Blade (U)	太空军鉴(美)
Soldier Blade Special - Caravan Stage (J)	太空军鉴(日)
Somer Assault (U)	以牙还牙(美)
Son Son II (J)	西游记２(日)
Sonic Spike - World Championship Beach Volleyball (U)	沙滩排球(美)
Soukoban World (J)	仓库番 (日)
Space Harrier (J)	时空战士(日)
Space Harrier (U)	时空战士(美)
Space Invaders - Fukkatsu no Hi (J)	太空入侵者(日)
Special Criminal Investigation (J)
Spin Pair (J)	钻石方块(日)
Spiral Wave (J)	旋风任务(日)
Splatterhouse (J)	鬼屋(日)
Splatterhouse (U)	鬼屋(美)
Stratego (J)	开心苹果棋(日)
Street Fighter II' - Champion Edition (J)	快打旋风2(日)
Strip Fighter II (J)	女人快打(日)
Super Metal Crusher (J)	超级金属杀手(日)
Super Momotarou Dentetsu (J)	桃太郎电铁(日)
Super Momotarou Dentetsu II (J)	桃太郎电铁2(日)
Super Star Soldier (J)	星霊鹗(日)
Super Star Soldier (U)	星霊鹗(美)
Super Volleyball (J)	超级排球(日)
Super Volleyball (U)	超级排球(美)
Susanoo Densetsu (J)	凄狂传说(日)
Taito Chase H.Q. (J)
Taito Chase H.Q. (U)
Takahashi Meijin no Shin Boukenjima (J)
Takeda Shingen (J) [a]	武田信玄(日)[a]
Takeda Shingen (J)	武田信玄(日)
Takin' It to the Hoop (U)	美国职业篮球(美)
TaleSpin (U)	泰瑞熊(美)
Tatsujin (J) (Proto)	宇宙达人(日) (Proto)
Tatsujin (J)	宇宙达人(日)
Tatsunoko Fighter (J)
Tennokoe Bank (J)	天之声(日)
Tenseiryuu - Saint Dragon (J)	天圣龙(日)
Terra Cresta II - Mandoraa no Gyakushuu (J)	逆袭２(日)
Thunder Blade (J)	战斗直升机(日)
Tiger Road (U)	虎之道(美)
Time Cruise (U)	弹珠台(美)
Time Cruise II (J)	弹珠台2(日)
Timeball (U)	时光球(美)
Titan (J)	泰坦球(日)
Toilet Kids (J)	马桶小子(日)
Tora heno Michi (J)	虎之道(日)
Toshi Tensou Keikaku - Eternal City (J)	永恒的城市(日)
Tower of Druaga, The (J)	龙之塔(日)
Toy Shop Boys (J)	玩具小子(日)
Tricky (J)	动物金头脑(日)
Tricky Kick (U)	动物金头脑(美)
Tsuppari Oozumou - Heisei Ban (J)
Tsuru Teruhito no Jissen Kabushiki Bai Bai Game (J)
Turrican (U)	外星悍将(美)
TV Sports Basketball (J)	实况篮球(日)
TV Sports Basketball (U)	实况篮球(美)
TV Sports Football (J)	实况橄榄球(日)
TV Sports Football (U)	实况橄榄球(美)
TV Sports Hockey (J)	实况冰上曲棍球(日)
TV Sports Hockey (U)	实况冰上曲棍球(美)
USA Pro Basketball (J)	美国篮球(日)
Veigues - Tactical Gladiator (J)	机甲战士(日)
Veigues - Tactical Gladiator (U)	机甲战士(美)
Victory Run (J)	胜利赛车(日)
Victory Run (U)	胜利赛车(美)
Vigilante (J)	义警(日)
Vigilante (U)	义警(美)
Violent Soldier (J)	激烈战斗(日)
Volfied (J)
Wai Wai Mahjong - Yukaina Janyuu Tachi (J)	哇哇麻雀(日)
Walkuere no Densetsu (J)
Wallaby!! - Usagi no Kuni no Kangaroo Race (J)	小袋鼠(日)
Winning Shot (J)	胜利高尔夫(日)
Wonder Momo (J)
World Beach Volley (J)	世界海滩排球(日)
World Circuit (J)
World Class Baseball (U)	世界棒球(美)
World Court Tennis (U)	世界网球(美)
World Jockey (J)	世界赛马(日)
World Sports Competition (U)	超级运动员(美)
W-Ring - The Double Rings (J)	宇宙双鹰(日)
Xevious - Fardraut Densetsu (J)	铁板阵(日)
Yo, Bro (U)	Yo兄弟 (美)
Youkai Douchuuki (J)	妖怪道中记(日)
Yuu Yuu Jinsei - Victory Life (J)	游游人生(日)
Zero 4 Champ (J) (v1.5)	优胜者(日)(V1.5)
Zero 4 Champ (J)	优胜者(日)
Zipang (J)	所罗门之钥(日)