2020 Super Baseball (J)	超级棒球2020(日)
2020 Super Baseball (U)	超级棒球2020(美)
3 Jigen Kakutou Ballz (J) (Sample)
3 Jigen Kakutou Ballz (J)
3 Ninjas Kick Back (U)	忍者好小子(美)
3x3 Eyes - Juuma Houkan (J)
3x3 Eyes - Seima Kourinden (J)
4 Nin Shougi (J)
46 Okunen Monogatari - Harukanaru Eden he (J)
7th Saga, The (U)
90 Minutes - European Prime Goal (E) (Beta)	90分钟欧洲足球(欧)(测试版)
90 Minutes - European Prime Goal (E)	90分钟欧洲足球(欧)
'96 Zenkoku Koukou Soccer Senshuken (J)
AAAHH!!! Real Monsters (E)	怪物三人行(欧)
AAAHH!!! Real Monsters (U)	怪物三人行(美)
ABC Monday Night Football (J)	ABC电视台周一足球(日)
ABC Monday Night Football (U)	ABC电视台周一足球(美)
Accele Brid (J)	电脑战机(日)
Ace wo Nerae! (J)	山本玲美香网球(日)
ACME Animation Factory (E)	动书工厂(欧)
ACME Animation Factory (U)	动书工厂(美)
Acrobat Mission (J)	特殊任务(日)
Action Pachio (J)	柏青哥君大进击(日)
ActRaiser (E)	雷莎出击(欧)
ActRaiser (F)	雷莎出击(法)
ActRaiser (G)	雷莎出击(德)
ActRaiser (J)	雷莎出击(日)
ActRaiser (U) (NSS)	雷莎出击(美)(NSS)
ActRaiser (U)	雷莎出击(美)
ActRaiser 2 - Chinmoku heno Seisen (J)	雷莎出击2(日)
ActRaiser 2 (E) (M3)	雷莎出击2(欧)(M3)
ActRaiser 2 (U)	雷莎出击(美)
Addams Family Values (E) (M3)	阿达一族(欧) (M3)
Addams Family Values (U) (M3)	阿达一族(美) (M3)
Addams Family, The - Pugsley's Scavenger Hunt (E)	阿达一族3(欧)
Addams Family, The - Pugsley's Scavenger Hunt (U) (Beta)	阿达一族3(美) (测试版)
Addams Family, The - Pugsley's Scavenger Hunt (U)	阿达一族3(美)
Addams Family, The (E) (M3)	阿达一族(美)(M3)
Addams Family, The (J)	阿达一族(日)
Addams Family, The (U) (NSS)	阿达一族(美)(NSS)
Addams Family, The (U)	阿达一族(美)
Adventures of Batman & Robin, The (E)	蝙蝠侠和罗宾的冒险(欧)
Adventures of Batman & Robin, The (U)	蝙蝠侠和罗宾的冒险(美)
Adventures of Dr. Franken, The (E) (M7)	科学怪人的冒险(欧)(M7)
Adventures of Dr. Franken, The (U)	科学怪人的冒险(美)
Adventures of Kid Kleets, The (U) (M3)	足球小子的冒险(美)
Adventures of Rocky and Bullwinkle and Friends, The (U)
Adventures of Tintin, The - Prisoners of the Sun (E) (M4)
Adventures of Yogi Bear (U)
Aero Fighters (U)	铁鹰战士(美)
Aero the Acro-Bat (E)	飞天蝙蝠(欧)
Aero the Acro-Bat (U)	飞天蝙蝠(美)
Aero the Acro-Bat 2 (E)	飞天蝙蝠2(欧)
Aero the Acro-Bat 2 (U)	飞天蝙蝠2(美)
Aerobiz (U)	航空产业(美)
Aerobiz Supersonic (U)	航空产业-超音速版(美)
Aguri Suzuki F-1 Super Driving (E)
AIII S.V. - A Ressha de Ikou 3 Super Version (J)
Air Cavalry (E)	空中骑兵直升机(欧)
Air Cavalry (U)	空中骑兵直升机(美)
Air Management - Oozora ni Kakeru (J) (v1.0)	航空产业-日(日)(V1.0)
Air Management - Oozora ni Kakeru (J) (v1.1)	航空产业-日(日)(V1.1)
Air Management II - Koukuu Ou wo Mezase (J)	航空产业-日2(日)
Air Strike Patrol (U)	空中攻击巡逻员(美)
Akazukin Chacha (J)
Akumajou Dracula (J)	恶魔城(日)
Akumajou Dracula XX (J)	恶魔城XX(日)
Al Unser Jr.'s Road to the Top (E)	飞驰至頂点(欧)
Al Unser Jr.'s Road to the Top (U)	飞驰至頂点(美)
Aladdin (E)	阿拉丁(欧)
Aladdin (F)	阿拉丁(法)
Aladdin (G)	阿拉丁(德)
Aladdin (J)	阿拉丁(日)
Aladdin (S) [b]	阿拉丁(S)[B]
Aladdin (U) (Beta)	阿拉丁(美) (测试版)
Aladdin (U)	阿拉丁(美)
Albert Odyssey (J)	英雄圣战(日)
Albert Odyssey 2 - Jashin no Taidou (J)	英雄圣战2(日)
Alcahest (J)	地底魔神(日)
Alfred Chicken (E)	神险艾烈佛(欧)
Alice no Paint Adventure (J)	异形3(日)
Alien 3 (E)	异形3(欧)
Alien 3 (J)	异形3(日)
Alien 3 (U) (Beta)	异形3(美) (Beta)
Alien 3 (U)	异形3(美)
Alien vs. Predator (E)	异形对终极战士(欧)
Alien vs. Predator (U)	异形对终极战士(美)
Aliens vs. Predator (J)	异形对终极战士(日)
All-American Championship Football (E)	全美冠军足球赛(欧)
Amazing Spider-Man, The - Lethal Foes (J)
America Oudan Ultra Quiz (J)	美国橫断(日)
American Battle Dome (J)	对战弹珠台(日)
American Gladiators (U)	美国电视斗士(美)
American Tail, An - Fievel Goes West (E)	美国鼠谭-西部枪鼠(欧)
American Tail, An - Fievel Goes West (U)	美国鼠谭-西部枪鼠(美)
Andre Agassi Tennis (J)	阿格西网球(日)
Andre Agassi Tennis (U)	阿格西网球(美)
Angelique - Premium Box (J)	女王学院-限定版(日)
Angelique - Voice Fantasy (J)	女王学院-原声版(日)
Angelique (J)	女王学院(日)
Animal Buranden - Brutal (J)
Animaniacs (E)	卡通集锦(欧)
Animaniacs (J)	卡通集锦(日)
Animaniacs (U)	卡通集锦(美)
Another World (E)	另一个世界(欧)
Aoki Densetsu Shoot! (J)
Apocalypse II (E) (Beta)
Appleseed - Prometheus no Shintaku (J)	苹果核战(日)
Aqutallion (J)	超时空战士(日)
Arabian Nights - Sabaku no Seirei Ou (J)	阿拉伯奇遇(日)
Araiguma Rascal (J)	浣熊方块(日)
Arcade's Greatest Hits - The Atari Collection 1 (E)
Arcade's Greatest Hits - The Atari Collection 1 (U)
Arcana (U)	魔幻精灵卡(美)
Arcus Odyssey (U) (Beta)
Arcus Spirits (J)	亚克斯传说(日)
Ardy Lightfoot (E)	光脚阿迪(欧)
Ardy Lightfoot (J) (Beta)	光脚阿迪(日) (测试版)
Ardy Lightfoot (J)	光脚阿迪(日)
Ardy Lightfoot (U)	光脚阿迪(欧)
Area 88 (J)	战区88(日)
Aretha (J)	阿蕾莎(日)
Aretha II - Ariel no Fushigi na Tabi (J) (Sample)	阿蕾莎2(日)(样品)
Aretha II - Ariel no Fushigi na Tabi (J)	阿蕾莎2(日)
Arkanoid - Doh It Again (E)	打砖块(欧)
Arkanoid - Doh It Again (J)	打砖块(日)
Arkanoid - Doh It Again (U)	打砖块(美)
Art of Fighting (E)	龙虎之拳(欧)
Art of Fighting (U)	龙虎之拳(美)
Aryol (J)	动态拼图(日)
Asahi Shinbun Rensai - Katou Hifumi Kudan Shougi - Shingiryuu (J)	加藤123九段将棋(日)
Asameshimae Nyanko (J)	小猫物语(日)
Ashita no Joe (J)	小拳王(日)
Assault Suits Valken (J)	突击装甲(日)
Asterix & Obelix (E) (M4)	美丽新世界2(欧)(M4)
Asterix (E) (M4)	美丽新世界(欧)(M4)
124Atlas, The - Renaissance Voyager (J)	佛罗伦斯航海者(日)
Axelay (E)	银河风暴(欧)
Axelay (J)	银河风暴(日)
Axelay (U) (Sample)	银河风暴(美)(样品)
Axelay (U)	银河风暴(美)
B.O.B. (E)	蚂蚁战士(欧)
B.O.B. (U)	蚂蚁战士(美)
Bahamut Lagoon (J)	神龙骑兵/龙界传说/圣龙战记(日)
Baken Renkinjutsu (J)
Bakukyuu Renpatsu!! Super B-Daman (J)	弹珠超人(日)
Bakumatsu Kourinden Oni (J)	幕末降临传(日)
Bakutou Dochers - Bumps-tou ha Oosawagi (J)	暴投-动物大混战(日)
Ball Bullet Gun (J)	BB枪大作战 (日)
Ballz 3D (U)	3D球(美)
Barbarossa (J)	巴拿马战役(日)
Barbie Super Model (U)	芭比-超级模特儿(美)
Barbie Vacation Adventure (U)	芭比-假日冒险(美)
Barkley no Power Dunk (J)	巴克利强力灌篮(日)
Barkley Shut Up and Jam! (E)	巴克利篮球(欧)
Barkley Shut Up and Jam! (U)	巴克利篮球(美)
BASS Masters Classic - Pro Edition (E)	巴斯大师教室-专业(欧)
BASS Masters Classic - Pro Edition (U)	巴斯大师教室-专业(美)
BASS Masters Classic (J)	巴斯钓鱼大师教室(日)
BASS Masters Classic (U)	巴斯钓鱼大师教室(美)
Bassin's Black Bass (U)
Bastard!! - Ankoku no Hakaishin (J)	暗黑的破坏神(日)
Batman - Revenge of the Joker (U) (Beta)	蝙蝠侠-迷天大圣复仇记(美)
Batman (U) (Beta) [h]	蝙蝠侠(美)(测试)[H]
Batman Forever (E)	永远的蝙蝠侠(欧)
Batman Forever (J)	永远的蝙蝠侠(日)
Batman Forever (U)	永远的蝙蝠侠(美)
Batman Returns (E)	蝙蝠侠重现江湖(欧)
Batman Returns (J)	蝙蝠侠重现江湖(日)
Batman Returns (U)	蝙蝠侠重现江湖(美)
Battle Blaze (J)	究极战士(日)
Battle Blaze (U)	究极战士(美)
Battle Cars (U)	战斗赛车(美)
Battle Clash (E)	战斗冲击(欧)
Battle Clash (U)	战斗冲击(美)
Battle Commander - Hachibushuu, Shura no Heihou (J)	SD指挥官(日)
Battle Cross (J)	火柴摩托车赛(日)
Battle Dodge Ball - Toukyuu Daigekitotsu! (J)	SD躲避球(日)
Battle Dodge Ball II (J)	SD躲避球2(日)
Battle Grand Prix (J)	战斗GP赛车(日)
Battle Grand Prix (U)	战斗GP赛车(美)
Battle Jockey (J)	战斗赛马(日)
Battle Master - Kyuukyoku no Senshitachi (J)	格斗大师-究极之战士(日)
Battle Pinball (J)	SD弹珠台(日)
Battle Racers (J)	SD赛车(日)
Battle Robot Retsuden (J)	战斗机器人(日)
Battle Soccer - Field no Hasha (J)	SD足球(日)
Battle Soccer 2 (J)	SD足球2(日)
Battle Submarine (J)	战斗潜水艇(日)
Battle Tycoon - Flash Hiders SFX (J) (v1.0)	闪电斗士(日)(V1.0)
Battle Tycoon - Flash Hiders SFX (J) (v1.1)	闪电斗士(日)(V1.1)
Battle Zeque Den (J)	斗姬传(日)
Battletech (J)	银河战记(日)
Battletech 3050 (J)	机甲争霸3050年(日)
Battletoads & Double Dragon - The Ultimate Team (E)	忍者蛙与双截龙(欧)
Battletoads & Double Dragon - The Ultimate Team (U)	忍者蛙与双截龙(美)
Battletoads in Battlemaniacs (E)	忍者蛙(欧)
Battletoads in Battlemaniacs (J)	忍者蛙(日)
Battletoads in Battlemaniacs (U) (Beta)	忍者蛙(美)(测试版)
Battletoads in Battlemaniacs (U)	忍者蛙(美)
Bazoe! Mahou Sekai (J)
Bazooka Blitzkrieg (U)	激战火箭炮(美)
Beauty and the Beast (E) (Beta)	美女与野兽(欧)(测试版)
Beauty and the Beast (E)	美女与野兽(欧)
Beauty and the Beast (U)	美女与野兽(美)
Beavis and Butt-Head (E)	MTV双傻(欧)
Beavis and Butt-Head (U)	MTV双傻(美)
Bebe's Kids (U)	宝贝小孩(美)
Beethoven's 2nd - The Ultimate Canine Caper! (E)	我家也有贝多芬(欧)
Beethoven's 2nd - The Ultimate Canine Caper! (U)	我家也有贝多芬(美)
Benkei Gaiden - Suna no Shou (J)	弁庆外传-沙之章(日)
Best of the Best - Championship Karate (E) (Beta)	自由搏击(欧)(测试版)
Best of the Best - Championship Karate (E)	自由搏击(欧)
Best of the Best - Championship Karate (U)	自由搏击(美)
Best Shot Pro Golf (J)	专业一杆高尔夫球(日)
Big Ichigeki! Pachi-Slot Daikouryaku (J)	柏青哥嫂大攻略(日)
Big Ichigeki! Pachi-Slot Daikouryaku 2 - Universal Collection (J)	柏青哥嫂大攻略2(日)
Big Run - The Supreme 4WD Challenge (J)
Big Sky Trooper (E)	天空骑兵(欧)
Big Sky Trooper (U) (Beta)	天空骑兵(美)(测试版)
Big Sky Trooper (U)	天空骑兵(美)
Bijo to Yajuu (J)
Bike Daisuki! Hashiriya Damashii - Rider's Spirits (J)	魂电单车(日)
Biker Mice from Mars (E)	火星老鼠赛车(欧)
Biker Mice from Mars (U)	火星老鼠赛车(美)
Bill Laimbeer's Combat Basketball (U)	战斗篮球(美)
Bill Walsh College Football (U)	比尔华续大学篮球(美)
Bing Bing! Bingo (J)	乐趣宾果岛(日)
Bio Metal (E)	生化金属战机(欧)
Bio Metal (J)	生化金属战机(日)
Bio Metal (U)	生化金属战机(美)
091Bishin Densetsu Zoku (J)	美神传说(日)
Bishoujo Janshi Suchie-Pie (J) (v1.0)	美少女雀士(日) (V1.0)
Bishoujo Janshi Suchie-Pie (J) (v1.1)	美少女雀士(日) (V1.1)
Bishoujo Senshi Sailormoon - Another Story (J)	美少女战士2(日)
Bishoujo Senshi Sailormoon (J)	美少女战士(日)
Bishoujo Senshi Sailormoon R (J)	美少女战士R(日)
Bishoujo Senshi Sailormoon S - Jougai Rantou! Shuyaku Soudatsusen (J)	美少女战士射波2(日)
Bishoujo Senshi Sailormoon S - Kondo ha Puzzle de Oshioki yo! (J)	美少女战士S-2(日)
Bishoujo Senshi Sailormoon S - Kurukkurin (J)	美少女战士S-3(日)
Bishoujo Senshi Sailormoon Super S - Fuwa Fuwa Panic (J)	美少女战士射波(日)
Bishoujo Senshi Sailormoon Super S - Zenin Sanka!! Shuyaku Soudatsusen (J)	美少女战士超级S(日)
Bishoujo Wrestler Retsuden - Blizzard Yuki Rannyuu!! (J)
Blackhawk (E) (M3)	黑暗之鹰(欧)
Blackthorne - Fukushuu no Kuroki Kyoku (J)	黑暗之鹰(日)
Blackthorne (U) (Beta)	黑暗之鹰(美)(测试版)
Blackthorne (U) (Sample)	黑暗之鹰(美) (样品)
Blackthorne (U)	黑暗之鹰(美)
BlaZeon - The Bio-Cyborg Challenge (U)	究极合体战机(美)
BlaZeon (J)	究极合体战机(日)
Blazing Skies (E)	飞行密令(欧)
Block Kuzushi (J)	究极打砖块(日)
Blue Crystal Rod, The (J)	色水晶杖(日)
Blues Brothers, The (E) (Beta)	布鲁斯兄弟(欧)(测试版)
Blues Brothers, The (E)	布鲁斯兄弟(欧)
Blues Brothers, The (J)	布鲁斯兄弟(日)
Blues Brothers, The (U)	布鲁斯兄弟(美)
Bobby's World (U) (Beta)	波比的世界(美)(测试版)
Bokujou Monogatari (J) (v1.0)	牧场物语(日)(V1.0)
Bokujou Monogatari (J) (v1.1) (NP)	牧场物语(日)(V1.1)(NP)
Bomberman B-Daman (J)	轰炸超人益智篇(日)
Bombuzal (J)	爆破精灵(日)
Bonkers - Hollywood Daisakusen! (J)	邦克大进击(日)
Bonkers (U)	邦克大进击(美)
Boogerman - A Pick and Flick Adventure (E)	伯格人(欧)
Boogerman - A Pick and Flick Adventure (U)	伯格人(美)
Bounty Sword (J)	赏金剑客(日)
Boxing Legends of the Ring (E)	拳击-铃声传说(欧)
Boxing Legends of the Ring (U)	拳击-铃声传说(美)
Brain Lord (J)	智慧王者(日)
Brain Lord (U)	智慧王者(美)
Brainies, The (E)	动动脑(欧)
Brainies, The (U)	动动脑(美)
Bram Stoker's Dracula (E)	吸血鬼德古拉(欧)
Bram Stoker's Dracula (U) (Beta)	吸血鬼德古拉(美)(测试版)
Bram Stoker's Dracula (U)	吸血鬼德古拉(美)
Brandish (J)	星间游侠(日)
Brandish (U)	星间游侠(美)
Brandish 2 - Expert (J)	星间游侠2(日)
Brandish 2 - The Planet Buster (J)	星间游侠2(日)
Brawl Brothers (U)	快打刑事(美)
BreakThru! (U)	点点方块(美)
Breath of Fire - Ryuu no Senshi (J)	龙战士(日)
Breath of Fire (U)	龙战士(美)
Breath of Fire II - Shimei no Ko (J) (v1.0)	龙战士2(日)(V1.0)
Breath of Fire II - Shimei no Ko (J) (v1.1) (NP)	龙战士2(日)(V1.1)(NP)
Breath of Fire II (E)	龙战士2(欧)
Breath of Fire II (U)	龙战士2(美)
Brett Hull Hockey (E)	冰上曲棍球(欧)
Brett Hull Hockey (U)	冰上曲棍球(美)
Brett Hull Hockey '95 (U)	冰上曲棍球95(美)
Bronkie the Bronchiasaurus (U) (M2)
Brunswick World Tournament of Champions (U)
Brutal - Paws of Fury (E) (M3)	动物快打(欧)(M3)
Brutal - Paws of Fury (U) (Beta)	动物快打(美)(测试版)
Brutal - Paws of Fury (U)	动物快打(美)
BS Albert Odyssey (J)	英雄圣战(日)
BS Arkanoid - Doh It Again (J)	打砖块(日)
BS Chrono Trigger - Character Zukan (J)	超时空之轮-角色博物館(日)
BS Chrono Trigger - Jet Bike Special (J)	超时空之轮赛车(日)
BS Chrono Trigger - Music Library (J)	超时空之轮-音乐博物館(日)
BS Daibakushou Jinsei Gekijou (J)
BS Dandan Belt Conveyor - Ukulele no Maki (J) [b]	丹丹教学-克拉拉之卷(日)(B)
BS Digital Magazine - Busters BS 4-12 (J)
BS Dokapon Gaiden - Honoo no Audition (J)	多卡波王国外传(日)
BS Dr. Mario (J)	马力欧医生(日)
BS Dragon Slayer - Eiyuu Densetsu (J)	英雄传说(日)
BS Dynami Tracer (J)	太空竞赛(日)
BS Excitebike - Bunbun Mario Battle Stadium 1 (J)
BS Excitebike - Bunbun Mario Battle Stadium 2 (J)
BS Excitebike - Bunbun Mario Battle Stadium 3 (J) [7CD2]
BS Excitebike - Bunbun Mario Battle Stadium 3 (J) [936C]
BS Excitebike - Bunbun Mario Battle Stadium 4 (J)
BS F-Zero (J)	F零式赛车(日)
BS F-Zero Grand Prix 2 - Dai-1-Shuu (J)	F零式赛车2(日)
BS Golf Daisuki! O.B. Club (J)
BS Heisei Gunjin Shougi (J)	平成军人将棋(日)
BS Ikari no Yousai (J)	怒之要塞(日)
BS Kaizou Chounin Shubibin Man Zero (J)	改造村人Zero(日)
BS Kirby no Omochabako - Baseball (J)	卡比之玩具箱棒球(日)
BS Kodomo Chousadan Mighty Pockets Chousa 1 - Junk-ya Black no Ie (J)
BS Kodomo Chousadan Mighty Pockets Chousa 2 - Hanzai Toshi Big Apple (J)
BS Koi ha Balance - Tatoeba K-kun no Tabou na Ichijitsu Hen (J)
BS Let's Pachinko Nante Gindama 1 (J)	大家来打柏青哥1(日)
BS Let's Pachinko Nante Gindama 2 (J)	大家来打柏青哥2(日)
BS Let's Pachinko Nante Gindama 3 (J)	大家来打柏青哥3(日)
BS Let's Pachinko Nante Gindama 4 (J)	大家来打柏青哥4(日)
BS Lord Monarch (J)	魔那歌之主(日)
BS Mario Paint - BS Ban (J)	马力欧绘图(日)
BS Mario Paint - Yuushou Naizou Ban (J)	马力欧绘图(日)
BS Marvelous Camp Arnold Course - Dai-1-Shuu (J)	安德那露营路线1(日)
BS Marvelous Camp Arnold Course - Dai-2-Shuu (J)	安德那露营路线2(日)
BS Marvelous Camp Arnold Course - Dai-3-Shuu (J)	安德那露营路线3(日)
BS Marvelous Camp Arnold Course - Dai-4-Shuu (J)	安德那露营路线4(日)
BS Marvelous Time Athletic Course - Dai-1-Shuu (J)	安德那运动路线1(日)
BS Marvelous Time Athletic Course - Dai-2-Shuu (J)	安德那运动路线2(日)
BS Marvelous Time Athletic Course - Dai-3-Shuu (J)	安德那运动路线3(日)
BS Marvelous Time Athletic Course - Dai-4-Shuu (J)	安德那运动路线4(日)
BS Nichibutsu Mahjong - Renshuu Mahjong - Ichimantou (J)	通讯麻将(日)
BS Nichibutsu Mahjong - Renshuu Mahjong - Nimantou (J)	通讯麻将(日)
BS Nichibutsu Mahjong (J)	通讯麻将(日)
BS Nintama Rantarou 2 (J)	忍者乱太郎2(日)
BS Panel de Pon - Event '98 (J)	花仙子方块(日)
BS Parlor! Parlor! - Dai-2-Shuu (J)	居家777(日)
BS Shanghai - Banri no Choujou (J)	上海之万里长城(日)
2BS Special Tee Shot (J)	特殊撞球(日)
BS Spriggan Powered - BS Version (J)	装甲机神(日)
BS Super Earth Defense Force (J)	超级EDF(日)
BS Super Famicom Wars - BS Ban (J)	超级任天堂大战(日)
BS Super Mahjong Taikai (J)	超级麻将大会(日)
BS Super Mario USA - Dai-1-Kai (J)
BS Super Mario USA - Dai-2-Kai (J)
BS Super Mario USA - Dai-3-Kai (J)
BS Super Mario USA - Dai-4-Kai (J)
BS Super Ninja-kun (J)	超级忍者君(日)
BS Super Tsume Shougi 1000 (J)	超级将棋(日)
BS Sutte Hakkun - '98 Event Version (J)	抢救彩虹98(日)
BS Sutte Hakkun - BS Version 2 10-8 (J)	抢救彩虹-2-10-8(日)
BS Sutte Hakkun - BS Version 2 6-3 (J)	抢救彩虹-2-6-3(日)
BS Sutte Hakkun - Event Version (J)	抢救彩虹(日)
BS Treasure Conflix (J)	世界之财宝(日)
BS Wario no Mori Futatabi (J)	瓦力欧(日)
BS Wizardry V - Saika no Chuushin (J)	巫术5(日)
BS Yoshi no Panepon - BS Ban (J) (M2)	耀西方块(日)(M2)
BS Zelda no Densetsu - Kamigami no Triforce (J)	萨尔达传说-卫星版(日)
BS Zootto Mahjong - Preview Ban (J)	巨额麻将(日)
Bubsy II (E)	巴比斯2(欧)
Bubsy II (U)	巴比斯2(美)
Bubsy in Claws Encounters of the Furred Kind (E)	巴比斯(欧)
Bubsy in Claws Encounters of the Furred Kind (U) (Beta)	巴比斯(美)(测试版)
Bubsy in Claws Encounters of the Furred Kind (U)	巴比斯(美)
Bugs Bunny - Hachamecha Daibouken (J)	兔宝宝(日)
Bugs Bunny in Rabbit Rampage (E)	兔宝宝(欧)
Bugs Bunny in Rabbit Rampage (U)	兔宝宝(美)
Bulls vs Blazers and the NBA Playoffs (E) (v1.0)	公牛VS.Blazers(欧)(V1.0)
Bulls vs Blazers and the NBA Playoffs (E) (v1.1)	公牛VS.Blazers(欧)(V1.1)
Bulls vs Blazers and the NBA Playoffs (U) (v1.0)	公牛VS.Blazers(美)(V1.0)
Bulls vs Blazers and the NBA Playoffs (U) (v1.1)	公牛VS.Blazers(美)(V1.1)
Burai - Hachigyoku no Yuushi Densetsu (J)	光明八勇士(日)
Bushi Seiryuuden - Futari no Yuusha (J)	青龙传(日)
Bust-A-Move (U)	泡泡龙(美)
Cacoma Knight (J)	卡通天蚕变(日)
Cacoma Knight in Bizyland (U)
Cal Ripken Jr. Baseball (E)	卡尔棒球(欧)
Cal Ripken Jr. Baseball (U) (Beta)	卡尔棒球(美)(测试版)
Cal Ripken Jr. Baseball (U)	卡尔棒球(美)
California Games II (E) (M3)	加州游戏2(欧)(M3)
California Games II (J) (M2)	加州游戏2(日)(M2)
California Games II (U)	加州游戏2(美)
Cameltry (J)	360度滚球 (日)
Cannon Fodder (E)	勇士们(欧)
Cannondale Cup (U)	无敌风火轮脚踏车(美)
Capcom's MVP Football (U)	卡普空MVP足球(美)
Capcom's Soccer Shootout (U)	卡普空足球射网(美)
Captain America and the Avengers (E)	美国上尉(美)
Captain America and the Avengers (U)	美国上尉(美)
Captain Commando (E)	上尉密令(欧)
Captain Commando (J)	上尉密令(日)
Captain Commando (U)	上尉密令(美)
Captain Novolin (U) (M3)	健康管理上尉(美)(M3)
Captain Tsubasa III - Koutei no Chousen (J)	天使之翼3(日)
Captain Tsubasa IV - Pro no Rival-tachi (J)	天使之翼4(日)
Captain Tsubasa J - The Way to World Youth (J)	天使之翼J(日)
Captain Tsubasa V - Hasha no Shougou Campione (J)	天使之翼5(日)
Caravan Shooting Collection (J)	射击游戏合辑(日)
Card Master - Rimusaria no Fuuin (J)	魔幻精灵卡(日)
Carrier Aces (E)	神风特攻队(欧)
Carrier Aces (J)	神风特攻队(日)
Carrier Aces (U)	神风特攻队(美)
Casper (E)	鬼马小精灵(欧)
Casper (J)	鬼马小精灵(日)
Casper (U)	鬼马小精灵(美)
Castlevania - Dracula X (U)	恶魔城X(美)
Castlevania - Vampire's Kiss (E)	恶魔城(欧)
CB Chara Wars - Ushinawareta Gag (J)	CB世界(日)
Champions World Class Soccer (E) (M4)	世界级足球赛(欧)(M4)
Champions World Class Soccer (J)	世界级足球赛(日)
Champions World Class Soccer (U) (M4)	世界级足球赛(美)(M4)
Championship Pool (E)	撞球冠军赛(欧)
Championship Pool (U)	撞球冠军赛(美)
Championship Soccer '94 (U) (M4)	冠军足球赛94(美)(M4)
Chaos Engine, The (E)	混乱引擎(欧)
Chaos Seed - Fuusui Kairouki (J)	风水迴廊记(日)
Chavez (U) (Beta)	查尔斯拳击(美)(测试版)
Chavez (U)	查尔斯拳击(美)
Chavez II (U)	查尔斯拳击2(美)
Chessmaster, The (E)	西洋棋大师(欧)
Chessmaster, The (J)	西洋棋大师(日)
Chessmaster, The (U)	西洋棋大师(美)
Chester Cheetah - Too Cool to Fool (U)	起司豹(美)
Chester Cheetah - Wild Wild Quest (U) (Beta)	起司豹2(美)(测试版)
Chester Cheetah - Wild Wild Quest (U)	起司豹2(美)
Chibi Maruko-chan - Harikiri 365 Nichi no Maki (J)	小丸子-365天日记(日)
Chibi Maruko-chan - Mezase! Minami no Island!! (J)	小丸子-南国岛游乐(日)
Chinhai (J)	陈牌(日)
Choplifter III - Rescue Survive (E)	超级直升机3(欧)
Choplifter III - Rescue Survive (J)	超级直升机3(日)
Choplifter III - Rescue Survive (U) (Beta)	超级直升机3(美)(测试版)
Choplifter III - Rescue Survive (U) [7751]	超级直升机3(美)[7751]
Choplifter III - Rescue Survive (U) [D519]	超级直升机3(美)[D519]
Chou Aniki - Bakuretsu Rantou Hen (J)	超兄贵-爆裂乱斗篇(日)
Chou Mahou Tairiku Wozz (J)	超魔法大陆-沃茲(日)
Chou Makai Taisen! Dorabot-chan (J)	超魔界大战(日)
Chou Makaimura (J)
Choujikuu Yousai Macross - Scrambled Valkyrie (J)	超时空要塞(日)
Choukou Goukami Xardion (J)
Chrono Trigger (J) (Sample)	超时空之轮(日)(样品)
Chrono Trigger (J)	超时空之轮(日)
Chrono Trigger (U) (PSX)	超时空之轮(美)(PSX)
Chrono Trigger (U)	超时空之轮(美)
Chuck Rock (E)	呆呆原始人(欧)
Chuck Rock (U) (Beta)	呆呆原始人(美)(测试版)
Chuck Rock (U)	呆呆原始人(美)
Circuit USA (J)	美国巡迴赛车(日)
Civilization - Sekai Shichi Daibunmei (J)	文明帝国(日)
Civilization (U) (Beta)	文明帝国(美)(测试版)
Civilization (U)	文明帝国(美)
Classic Road (J)	文明帝国(日)
Classic Road II (J)	文明帝国2(日)
Clay Fighter - Tournament Edition (U)	变种格斗TE(美)
Clay Fighter (U)	变种格斗(美)
Clay Fighter 2 - Judgment Clay (E)	变种格斗2(美)
Clay Fighter 2 - Judgment Clay (U)	变种格斗2(美)
Claymates (E)	自由变形人(欧)
Claymates (U) (Sample)	自由变形人(美)(样品)
Claymates (U)	自由变形人(美)
Cliffhanger (E)	颠峰战士(美)
Cliffhanger (U)	颠峰战士(美)
Clock Tower (J)	时钟塔/钟楼惊魂计(日)
Clock Works (J)	时钟职人(日)
Clue (U)	生活大富翁(美)
College Football USA '97 - The Road to New Orleans (U)
College Slam (U)	大学篮球(美)
Columns (J) (NP)	宝石方块(日)(NP)
Combatribes, The (J)	庞克勇士(日)
Combatribes, The (U)	庞克勇士(美)
Computer Nouryoku Kaiseki - Ultra Baken (J)	脑力分析必胜马券(日)
Congo the Movie - The Secret of Zinj (U) (Beta)
Congo's Caper (E)	刚果小子(欧)
Congo's Caper (U)	刚果小子(美)
Contra III - The Alien Wars (U)	魂斗罗3(美)
Contra Spirits (J)	魂斗罗(日)
Conveni Wars Barcode Battler Senki - Super Senshi Shutsugeki seyo! (J)
Cool Spot (E)	酷小子(欧)
Cool Spot (J)	酷小子(日)
Cool Spot (U) (Beta)	酷小子(美)
Cool Spot (U)	酷世界(美)
Cool World (U)	酷世界(美)
Corn Buster (E) (Beta)
Coron Land (J)	可龙岛(日)
Cosmo Gang - The Puzzle (J)	外星大眼生物方块(日)
Cosmo Gang - The Video (J)	外星大眼小蜜蜂
Cosmo Police Galivan II - Arrow of Justice (J)	外星特警2(日)
Crayon Shin-chan - Arashi wo Yobu Enji (J)	蜡笔小新-幼稚园风云儿(日)
Crayon Shin-chan 2 - Daimaou no Gyakushuu (J)	蜡笔小新2-大魔王反攻(日)
Crystal Beans From Dungeon Explorer (J)	晶沙之城堡探险
Cu-On-Pa SFC (J)	酷昂八(日)
CutThroat Island (E)	割喉岛(欧)
CutThroat Island (U)	割喉岛(美)
Cyber Knight (J)	资讯骑士(日)
Cyber Knight II - Chikyuu Teikoku no Yabou (J)	资讯骑士2(日)
Cyber Spin (U)	迴旋环绕赛车(美)
Cybernator (E)	机动装甲(欧)
Cybernator (U) (With Sound Test)	机动装甲(美)(声测版)
Cybernator (U)	机动装甲(美)
Cyborg 009 (J) (Beta)	无敌超人009(日)(测试版)
Cyborg 009 (J)	无敌超人009(日)
Daffy Duck - The Marvin Missions (E)	达菲鸭-火星任务(欧)
Daffy Duck - The Marvin Missions (U)	达菲鸭-火星任务(美)
Dai-3-Ji Super Robot Taisen (J) (v1.0)	第3次机器人大战(日)(V1.0)
Dai-3-Ji Super Robot Taisen (J) (v1.2)	第3次机器人大战(日)(V1.2)
Dai-4-Ji Super Robot Taisen (J) (v1.0)	第4次机器人大战-1.0(日)
Dai-4-Ji Super Robot Taisen (J) (v1.1)	第4次机器人大战-1.1(日)
Daibakushou Jinsei Gekijou - Dokidoki Seishun Hen (J)	大爆笑人生剧场(日)
Daibakushou Jinsei Gekijou - Ooedo Nikki (J)	人生剧场-青春篇(日)
Daibakushou Jinsei Gekijou - Zukkoke Salary Man Hen (J)	人生剧场-大江戶日记(日)
Daibakushou Jinsei Gekijou (J)	人生剧场-无常篇(日)
Daikaijuu Monogatari (J) (v1.0)	大贝兽物语-1.0(日)
Daikaijuu Monogatari (J) (v1.1) (NP)	大贝兽物语-1.0(日)(NP)
Daikaijuu Monogatari II (J)	大贝兽物语2(日)
Daikoukai Jidai II (J)	大航海时代2(日)
Daisenryaku Expert (J)	大战略-专业版(日)
Daisenryaku Expert WWII - War in Europe (J)	大战略2(日)
Darius Force (J)	太空战斗机(日)
Darius Twin (E)	太空战斗机2(欧)
Darius Twin (J)	太空战斗机2(日)
Darius Twin (U)	太空战斗机2(美)
Dark Half (J)	黑暗领域(日)
Dark Kingdom (J)	黑暗领域(日)
Dark Law - Meaning of Death (J)	伊达公子网球(日)
Date Kimiko no Virtual Tennis (J)	伊达公子网球(日)
David Crane's Amazing Tennis (E)	大卫克拉尼网球(欧)
David Crane's Amazing Tennis (J)	大卫克拉尼网球(日)
David Crane's Amazing Tennis (U) (NSS)	大卫克拉尼网球(美)(NSS)
David Crane's Amazing Tennis (U)	大卫克拉尼网球(美)
Daze Before Christmas (E)	圣诞老人大进击(欧)
Dead Dance (J)	死亡烈斗(日)
Deae Tonosama - Appare Ichiban (J)	白痴殿下总动员(日)
Dear Boys (J)	灌篮少年(日)
Death and Return of Superman, The (E)	超人-死里逢生(欧)
Death and Return of Superman, The (U)	超人-死里逢生(美)
Death Brade (J)	死亡摔角(日)
Dekitate High School (J)	美少女高校经营(日)
Demolition Man (E)	毁灭者(欧)
Demolition Man (U)	毁灭者(美)
Demon's Blazon - Makaimura Monshou Hen (J)	魔界村外传-紋章篇(日)
Demon's Crest (E)	魔界村外传-紋章篇(欧)
Demon's Crest (U)	魔界村外传-紋章篇(美)
Dennis (E)
Dennis the Menace (U)	丹尼斯家中历险(美)
Densetsu no Ogre Battle - The March of the Black Queen (J) (NP)	皇家骑士团(日)(NP)
Densetsu no Ogre Battle - The March of the Black Queen (J)	皇家骑士团(日)
Derby Jockey - Kishu Ou heno Michi (J) (v1.0)	德贝赛马-骑手王之道(日)(V1.0)
Derby Jockey - Kishu Ou heno Michi (J) (v1.1) (NP)	德贝赛马-骑手王之道(日)(1.1)(NP)
Derby Jockey 2 (J)	德贝赛马2(日)
Derby Stallion '96 (J)	德贝育马96(日)
Derby Stallion '98 (J) (NP)	德贝育马98(日)(NP)
Derby Stallion II (J)	德贝育马2(日)
Derby Stallion III (J) (v1.0)	德贝育马3(日)(V1.0)
Derby Stallion III (J) (v1.2)	德贝育马3(日)(V1.2)
Desert Fighter - Suna no Arashi Sakusen (J)	沙漠雄鹰(日)
Desert Fighter (E) (Beta)	沙漠雄鹰(欧)(测试版)
Desert Fighter (E)	沙漠雄鹰(欧)
Desert Strike - Return to the Gulf (E)	沙漠风暴(美)
Desert Strike - Return to the Gulf (U)	沙漠风暴(美)
Desert Strike - Wangan Sakusen (J)	沙漠风暴(日)
Destructive (J)	导弹毁灭者(日)
Devil's Course (J) (Sample)	魔鬼课程训练高尔夫(日)(样品)
Devil's Course (J)	魔鬼课程训练高尔夫(日)
D-Force (U)	地球防卫部队(美)
Dharma Doujou (J)	达摩道场 (日)
Dig & Spike Volleyball (U)	排球世界决定战(美)
Dimension-Force (J)	垂直作战(美)
Dino City (E)	恐龙王国大冒险(欧)
Dino City (U)	恐龙王国大冒险(美)
Dino Dini's Soccer! (E) (M3)	迪诺足球(欧)
Dinowars - Kyouryuu Oukoku heno Daibouken (J)
Dirt Racer (E) (M3)	脏污赛车(欧)(M3)
Dirt Trax FX (E)	立体黑暗摩托车(欧)
Dirt Trax FX (U)	立体黑暗摩托车(美)
Dokapon 3-2-1 - Arashi wo Yobu Yuujou (J)	多卡波王国3.2.1(日)
Dokapon Gaiden - Honoo no Audition (J)	多卡波王国外传(日)
Dokuritsu Sensou - Liberty or Death (J)
Dolucky no A.League Soccer (J)	猫仔哥足球(日)
Dolucky no Kusayakiu (J)	猫仔哥棒球(日)
Dolucky no Puzzle Tour '94 (J)	94猫仔哥方块(日)
Donald Duck no Mahou no Boushi (J)	唐老鸭-魔法之法螺(日)
Donald Duck no Maui Mallard (J)	唐老鸭-茂伊煮鸭记(日)
Donald in Maui Mallard (E)	唐老鸭-茂伊煮鸭记(欧)
Donkey Kong Country - Competition Edition (U)	超级大金刚(美)
Donkey Kong Country (E) (M3) (v1.0)	超级大金刚1.0(欧)
Donkey Kong Country (E) (M3) (v1.1)	超级大金刚1.1(欧)
Donkey Kong Country (U) (v1.0)	超级大金刚1.0(美)
Donkey Kong Country (U) (v1.1)	超级大金刚1.1(美)
Donkey Kong Country (U) (v1.2)	超级大金刚1.2(美)
Donkey Kong Country 2 - Diddy's Kong Quest (E) (M2) (v1.1)	超级大金刚2-1.1(欧)(M2)
Donkey Kong Country 2 - Diddy's Kong Quest (G) (M2) (v1.0)	超级大金刚2-1.0(G)(M2)
Donkey Kong Country 2 - Diddy's Kong Quest (G) (M2) (v1.1)	超级大金刚2-1.1(G)(M2)
Donkey Kong Country 2 - Diddy's Kong Quest (U) (M2) (v1.0)	超级大金刚2-1.0(美)(M2)
Donkey Kong Country 2 - Diddy's Kong Quest (U) (M2) (v1.1)	超级大金刚2-1.0(美)(M2)
Donkey Kong Country 3 - Dixie Kong's Double Trouble (E) (M3)	超级大金刚3(欧)(M3)
Donkey Kong Country 3 - Dixie Kong's Double Trouble (U) (M2)	超级大金刚3(美)(M2)
Doom (E)	毁灭战士(欧)
Doom (J)	毁灭战士(美)
Doom (U)	毁灭战士(美)
Doom Troopers (U)	毁灭骑兵(美)
Doomsday Warrior (U)	末日战士(美)
Doraemon - Nobita to Yousei no Kuni (J)	小叮当-大雄与妖精王国(日)
Doraemon 2 - Nobita no Toys Land Daibouken (J)	小叮当2(日)
Doraemon 3 - Nobita to Toki no Hougyoku (J)	小叮当3(日)
Doraemon 4 - Nobita to Tsuki no Oukoku (J)	小叮当4(日)
Do-Re-Mi Fantasy - Milon no Dokidoki Daibouken (J)	多拉米的幻想(日)
Dossun! Ganseki Battle (J)	岩石方块大战(日)
Double Dragon V - The Shadow Falls (E)	双截龙5(欧)
Double Dragon V - The Shadow Falls (U)	双截龙5(美)
Doukyuusei 2 (J) (NP)	同级生2(NP)
Down the World - Mervil's Ambition (J)	直到世界末日(日)
Downtown Nekketsu Baseball Monogatari - Yakyuu de Shoubu da! Kunio-kun (J)	热血棒球(日)
Dr. Mario (J) (NP)	马力欧医生(日)(NP)
Dragon - The Bruce Lee Story (E)	李小龙传(欧)
Dragon - The Bruce Lee Story (U)	李小龙传(美)
Dragon Ball Z - Chomutujeon (K)	七龙珠(韩)
Dragon Ball Z - Chou Gokuuden - Kakusei Hen (J)	超悟空传-突激篇(日)
Dragon Ball Z - Chou Gokuuden - Totsugeki Hen (J)	超悟空传-觉醒篇(日)
Dragon Ball Z - Hyper Dimension (F)	七龙珠-超次元战记(法)
Dragon Ball Z - Hyper Dimension (J)	七龙珠-武斗传(法)
Dragon Ball Z - La Legende Saien (F)	七龙珠-武斗传(法)
Dragon Ball Z - Super Butouden (F)	七龙珠-超武斗传(法)
Dragon Ball Z - Super Butouden (J)	七龙珠-超武斗传(日)
Dragon Ball Z - Super Butouden 2 (J) (v1.0)	七龙珠-超武斗传2-1.0(日)
Dragon Ball Z - Super Butouden 2 (J) (v1.1)	七龙珠-超武斗传2-1.1(日)
Dragon Ball Z - Super Butouden 3 (J)	七龙珠-超武斗传3(日)
Dragon Ball Z - Super Saiya Densetsu (J) (v1.0)	七龙珠-超级赛亚人传说1.0(日)
Dragon Ball Z - Super Saiya Densetsu (J) (v1.1)	七龙珠-超级赛亚人传说1.1(日)
Dragon Ball Z - Ultime Menace (F)	七龙珠-超武斗传3(法)
Dragon Knight 4 (J)	龙骑士4(日)
Dragon Quest I & II (J)	勇者斗恶龙1&2(日)
Dragon Quest III - Soshite Densetsu he... (J)	勇者斗恶龙3(日)
Dragon Quest V - Tenkuu no Hanayome (J)	勇者斗恶龙6(日)
Dragon Quest VI - Maboroshi no Daichi (J)	勇者斗恶龙6(日)
Dragon Slayer - Eiyuu Densetsu (J) (v1.0)	英雄传说1.0(日)
Dragon Slayer - Eiyuu Densetsu (J) (v1.1) (NP)	英雄传说1.1(日)
Dragon Slayer - Eiyuu Densetsu II (J)	英雄传说2(日)
Dragon View (U)	屠龙战士2(美)
Dragon's Earth (J)	龙族地球(日)
Dragon's Lair (E) (Beta)	龙穴(欧)(测试版)
Dragon's Lair (E) (M7)	龙穴(欧)(M7)
Dragon's Lair (U)	龙穴(美)
Dragon's Magic (J)	龙穴(日)
Drakkhen (E)	屠龙传记(欧)
Drakkhen (G)	屠龙传记(德)
Drakkhen (J)	屠龙传记(日)
Drakkhen (U)	屠龙传记(美)
Dream Basketball - Dunk & Hoop (J)	梦幻篮球赛(日)
Dream TV (U) (Alternate Beta)	梦幻电视(美)(测试版A)
Dream TV (U) (Beta)	梦幻电视(美)(测试版)
Dream TV (U)	梦幻电视(美)
Drift King Shutokou Battle 2 - Tsuchiya Keiichi & Bandou Masaaki (J)	首都高赛车2(日)
Drift King Shutokou Battle '94 - Tsuchiya Keiichi & Bandou Masaaki (J)	94首都高赛车(日)
Dual Orb - Seirei Tama Densetsu (J)	圣灵珠传说(日)
Dual Orb II (J)	圣灵珠传说2(日)
Duel, The - Test Drive II (E)
Duel, The - Test Drive II (U)
Dun Quest - Majin Fuuin no Densetsu (J)	魔神封印传说(日)
Dungeon Master (E)	迷宫魔兽(欧)
Dungeon Master (J) (v1.0)	迷宫魔兽1.1(日)
Dungeon Master (J) (v1.1)	迷宫魔兽1.1(日)
Dungeon Master (U)	迷宫魔兽(美)
Dynamaite the Las Vegas (J)	赌城大战(日)
Dynamic Stadium (J)	动感棒球(日)
E.V.O. - Search for Eden (U)	46亿年物语(美)
Earth Light - Luna Strike (J)	太空模拟战2(日)
Earth Light (J)	太空模拟战(日)
EarthBound (U)	地球冒险(美)
Earthworm Jim - Gamesmaster Special Edition (U)	蚯蚓吉姆-玩家特别版(美)
Earthworm Jim (E)	蚯蚓吉姆(欧)
Earthworm Jim (J)	蚯蚓吉姆(日)
Earthworm Jim (U)	蚯蚓吉姆(美)
Earthworm Jim 2 (E)	蚯蚓吉姆2(欧)
Earthworm Jim 2 (U)	蚯蚓吉姆2(美)
Edono Kiba (J)	牙(日)
Eek! The Cat (E)	依凯猫(欧)
Eek! The Cat (U)	依凯猫(美)
Eien no Filerna (J)	未来勇者(日)
Elfaria - The Isle of the Blest (J)	未来勇者(日)
Elfaria II - The Quest of the Meld (J)	未来勇者2(日)
Elite Soccer (U)	精华足球(美)
Elnard (J)	翡翠龙(日)
Emerald Dragon (J)	翡翠龙(日)
Emit Vol. 1 - Toki no Maigo (J)	时之迷子(日)
Emit Vol. 2 - Inochigake no Tabi (J)	时之迷子2(日)
Emit Vol. 3 - Watashi ni Sayonara wo (J)	时之迷子3(日)
Emmitt Smith Football (U)	钢铁阵容足球(美)
Energy Breaker (J)	秘境魔宝(欧)
Equinox (E)	秘境魔宝(欧)
Equinox (U) (Beta)	秘境魔宝(美)(测试版)
Equinox (U)	秘境魔宝(美)
Eric Cantona Football Challenge (E) (M7)	爱瑞克足球(欧)(M7)
Esparks - Ijikuu Kara no Raihousha (J)	异次元来访者(日)
ESPN Baseball Tonight (E)	今晚棒球转播(欧)
ESPN Baseball Tonight (U) [2934]	今晚棒球转播(美)
ESPN Baseball Tonight (U) [73AB]	今晚棒球转播(美)
ESPN National Hockey Night (U)	晚间曲棍球转播(美)
ESPN Speedworld (U) (Beta)	超速世界赛车转播(美)(测试版)
ESPN Speedworld (U)	超速世界赛车转播(美)
ESPN Sunday Night NFL (U)	星期日晚间NFL赛(美)
Estpolis Denki (J)	四狂神战记(日)
Estpolis Denki II (J)	四狂神战记2(日)
Euro Football Champ (E)	欧洲冠军杯足球赛(欧)
Europe Sensen (J)	欧陆战线(日)
Exertainment Life Fitness Mega Cart (E) (Beta)
Exertainment Mountain Bike Rally (U)	越野脚踏车(美)
Exhaust Heat (E)	热爆赛车(欧)
Exhaust Heat (J)	热爆赛车(日)
Exhaust Heat II - F1 Driver heno Kiseki (J)	热爆赛车2(日)
Extra Innings (U)	白热野球(美)
Eye of the Beholder (J)	偷窥之眼(日)
Eye of the Beholder (U)	偷窥之眼(美)
F-1 Grand Prix - Part II (J)	F1GP赛车2(日)
F-1 Grand Prix - Part III (J)	F1GP赛车3(日)
F-1 Grand Prix (J)	F1GP赛车(日)
F1 Pole Position (E)	F1极致场地赛(欧)
F1 Pole Position (U)	F1极致场地赛(美)
F1 Pole Position 2 (E)	F1极致场地赛2(欧)
F1 ROC - Race of Champions (U)	F1冠军赛车(美)
F1 ROC II - Race of Champions (U)	F1冠军赛车2(美)
F1 World Championship Edition (E)	F1世界冠军赛(欧)
F-15 Super Strike Eagle (J)
Faceball 2000 (U)	小精灵炮弹大对决(美)
Famicom Bunko - Hajimari no Mori (J) (NP)
Famicom Tantei Club Part II - Ushiro ni Tatsu Shoujo (J) (v1.0) (NP)	任天堂侦探俱乐部2-1.0(日)(NP)
Famicom Tantei Club Part II - Ushiro ni Tatsu Shoujo (J) (v1.1) (NP)	任天堂侦探俱乐部2-1.1(日)(NP)
Family Dog (E)	家有笨狗(欧)
Family Dog (U)	家有笨狗(美)
Family Feud (U)	领地战役(美)
Farland Story (J)	剑士法蘭多(日)
Farland Story 2 (J)	剑士法蘭多2(日)
Fatal Fury (E)	饿狼传说(欧)
Fatal Fury (U)	饿狼传说(美)
Fatal Fury 2 (E)	饿狼传说2(欧)
Fatal Fury 2 (U)	饿狼传说(美)
Fatal Fury Special (E) [F207]	饿狼传说特别版(欧)[F207]
Fatal Fury Special (E) [F474]	饿狼传说特别版(欧)[F474]
Fatal Fury Special (U)	饿狼传说特别版(美)
Feda - The Emblem of Justice (J) (Beta)	王者之师/正义之纹章(日)(测试版)
Feda - The Emblem of Justice (J)	王者之师/正义之纹章(日)
Fever Pitch Soccer (E) (Beta)	狂热足球(欧)(测试版)
Fever Pitch Soccer (E) (M5)	狂热足球(欧)(M5)
FIFA '97 - Gold Edition (E) (M6)	FIFA足球赛97(欧)(M6)
FIFA '97 - Gold Edition (U) (M6)	FIFA足球赛97(美)(M6)
FIFA '98 - Road to World Cup (E) (M6)	FIFA足球赛98(欧)(M6)
FIFA International Soccer (E)	FIFA国际足球赛(欧)
FIFA International Soccer (J)	FIFA国际足球赛(日)
FIFA International Soccer (U)	FIFA国际足球赛(美)
FIFA Soccer '96 (E) (M6)	FIFA足球赛96(欧)(M6)
FIFA Soccer '96 (U) (M6)	FIFA足球赛96(美)(M6)
Fighter's History - Mizoguchi Kikiippatsu!! (J)	格斗烈传(日)
Fighter's History (J)	格斗烈传(日)
Fighter's History (U) (Beta)	格斗烈传(美)(测试版)
Fighter's History (U) (v1.1)	格斗烈传1.1(美)
Fighting Baseball (J)	战斗棒球(日)
Final Fantasy - Mystic Quest (U) (v1.0)	最终幻想外传1.0(美)
Final Fantasy - Mystic Quest (U) (v1.1)	最终幻想4-1.0(美)
Final Fantasy II (U) (v1.0)	最终幻想4-1.0(美)
Final Fantasy II (U) (v1.1)	最终幻想6-1.0(美)
Final Fantasy III (U) (v1.0)	最终幻想6-1.0(美)
Final Fantasy III (U) (v1.1)	最终幻想6-1.1(美)
Final Fantasy IV - Easy Type (J)	最终幻想4(日)
Final Fantasy IV (J) (v1.1)	最终幻想4-1.1(日)
Final Fantasy USA - Mystic Quest (J)	最终幻想外传(日)
Final Fantasy V (J)	最终幻想6(日)
Final Fantasy VI (J)	最终幻想6(日)
Final Fight (E)	街头快打(欧)
Final Fight (J)	街头快打(日)
Final Fight (U)	街头快打(美)
Final Fight 2 (E)	街头快打2(欧)
Final Fight 2 (J)	街头快打2(日)
Final Fight 2 (U)	街头快打2(美)
Final Fight 3 (E)	街头快打3(欧)
Final Fight 3 (U) (Beta)	街头快打3(美)(测试版)
Final Fight 3 (U)	街头快打3(美)(测试版)
Final Fight Guy (J)	街头快打-凯(日)
Final Fight Guy (U)	街头快打-凯(美)
Final Fight Tough (J)	街头快打3(日)
Final Knockout (J)	最后一拳击倒(日)
Final Stretch (J)	最后一圈 (日)
Finalset (J)
Fire Emblem - Monshou no Nazo (J) (v1.0)	圣火降魔录/火焰紋章-紋章之迷1.0(日)
Fire Emblem - Monshou no Nazo (J) (v1.1)	圣火降魔录/火焰紋章-紋章之迷1.1(日)
Fire Emblem - Seisen no Keifu (J)	圣火降魔录/火焰紋章-圣战之系谱(日)
Fire Emblem - Thracia 776 (J) (NP)	圣火降魔录/火焰紋章776(日)(NP)
Fire Emblem - Thracia 776 (J)	圣火降魔录/火焰紋章776(日)
Fire Fighting (J)	救火战士 (日)
Fire Pro Joshi All Star Dream Slam (J)	火爆女子摔角(日)
Fire Striker (U) (Beta)	爆裂斗球(美)(测试版)
Fire Striker (U)	爆裂斗球(美)
Firemen, The (E) (M3)	消防员(欧)(M3)
Firemen, The (J)	消防员(日)
Firepower 2000 (U)	火力战车2000(美)
First Queen - Ornic Senki (J)	凯萨林女皇(日)
First Samurai (E) [95C2]	第一武士(欧)[95C2]
First Samurai (E) [BFDB]	第一武士(欧)[BFDB]
First Samurai (J)	第一武士(日)
First Samurai (U)	第一武士(美)
Fishing Koushien (J)	甲子园(日)
Flashback - The Quest for Identity (U) (M3)	回到原点(美)(M3)
Flashback (E) (M2)	回到原点(欧)(M3)
Flashback (E) (M3)	回到原点(欧)(M3)
Flashback (J)	回到原点(日)
Flintstones, The - The Treasure of Sierra Madrock (E)	石头族乐园-升官版(欧)
Flintstones, The - The Treasure of Sierra Madrock (J)	石头族乐园-升官版(日)
Flintstones, The - The Treasure of Sierra Madrock (U)	石头族乐园-升官版(美)
Flintstones, The (E) (M6) (Beta)	石头族乐园-电影版(欧)(测试版)(M6)
Flintstones, The (E) (M6)	石头族乐园-电影版(欧)(M6)
Flintstones, The (U) (M6)	石头族乐园-电影版(美)(M6)
Flying Hero - Bugyuru no Daibouken (J)	飞行英雄(日)
Football Fury (U)	美式足球大战(美)
Foreman For Real (E)	真实拳击(欧)
Foreman For Real (J)	真实拳击(日)
Foreman For Real (U)	真实拳击(美)
Fortune Quest - Dice wo Korogase (J)	命运传说(日)
Frank Thomas Big Hurt Baseball (E)	法蘭克的大棒一挥(欧)
Frank Thomas Big Hurt Baseball (J)	法蘭克的大棒一挥(日)
Frank Thomas Big Hurt Baseball (U)	法蘭克的大棒一挥(美)
Frantic Flea (E) (Beta)	疯狂跳蚤(欧)(测试版)
Frantic Flea (E)	疯狂跳蚤(欧)
Frantic Flea (U)	疯狂跳蚤美)
Frogger (U)	青蛙过街(美)
From TV Animation Slam Dunk - Dream Team - Shueisha Limited (J)	灌蓝高手(日)
From TV Animation Slam Dunk - SD Heat Up!! (J)	灌蓝高手(日)
From TV Animation Slam Dunk - Shikyou Gekitotsu!! (J)	灌蓝高手(日)
From TV Animation Slam Dunk 2 - IH Yosen Kanzen Ban!! (J)	灌蓝高手2(日)
Front Mission (J) (v1.0)	雷霆任务1.0(日)
Front Mission (J) (v1.1)	雷霆任务1.1(日)
Front Mission Series - Gun Hazard (J)	雷霆任务外传(日)
Full Power (J)	动力十足大竞速(日)
Full Throttle Racing (E)	全速狂飙(欧)
Full Throttle Racing (U) (Beta)	全速狂飙(美)(测试版)
Full Throttle Racing (U)	全速狂飙(美)
Fun 'n Games (E)	乐趣游戏(欧)
Fun 'n Games (U)	乐趣游戏(美)
Funaki Masakatsu Hybrid Wrestler - Tougi Denshou (J)	船木诚胜-斗技传承(日)
Fune Tarou (J)	船太郎(日)
Furuta Atsuya no Simulation Pro Yakyuu 2 (J)
Fushigi no Dungeon 2 - Fuurai no Shiren (J) (v1.0)	风尘英雄/风来之西林1.0(日)
Fushigi no Dungeon 2 - Fuurai no Shiren (J) (v1.1) (NP)	风尘英雄/风来之西林1.1(日)(NP)
F-Zero (E)	F零式赛车(欧)
F-Zero (J)	F零式赛车(日)
F-Zero (U)	F零式赛车(美)
G.O.D - Mezame yo to Yobu Koe ga Kikoe (J)	G.O.D幻想世纪(日)
Gaia Gensouki (J)	盖亚幻想记(日)
Gaia Saver - Hero Saidai no Sakusen (J)	盖亚战记(日)
Gakkou de Atta Kowai Hanashi (J)	学校怪谈(日)
Galaxy Robo (J)	银河骑兵机器人(日)
Galaxy Wars (J)	银河大战(日)
Gambler Jikochuushinha - Mahjong Kouisen (J)	自己中心派(日)
Gambler Jikochuushinha 2 - Dorapon Quest (J)	自己中心派2(日)
Gambling Hourouki (J)	赌城放浪记(日)
Game Genie BIOS (U) (Unl) [a]	游戏精灵金手指(美)(unl)[a]
Game Genie BIOS (U) (Unl)	游戏精灵金手指(美)(unl)
Game Genie BIOS (U) (v2.0) (Unl)	游戏精灵金手指2.0(美)(unl)
Game no Tatsujin (J)	游戏达人(日)
Game no Tetsujin - The Shanghai (J)	游戏铁人-上海篇(日)
Gamera - Gyaos Gekimetsu Sakusen (J)	飞天神龟-卡美拉(日)
Ganbare Goemon - Yuki Hime Kyuushutsu Emaki (J) (v1.0)	大盗伍佑卫门1.0(日)
Ganbare Goemon - Yuki Hime Kyuushutsu Emaki (J) (v1.2)	大盗伍佑卫门1.2(日)
Ganbare Goemon 2 - Kiteretsu Shougun Magginesu (J)	大盗伍佑卫门2(日)
Ganbare Goemon 3 - Shishi Juuroku Hyoue no Karakuri Manjigatame (J)	大盗伍佑卫门3(日)
Ganbare Goemon Kirakira Douchuu - Boku ga Dancer ni Natta Riyuu (J)	大盗伍佑卫门(日)
Ganbare! Daiku no Gen-san (J)
Gangan Gan-chan (J)
Ganpuru - Gunman's Proof (J)
Ganso Pachi-Slot Nihonichi (J)
Garou Densetsu - Shukumei no Tatakai (J)	饿狼传说(日)
Garou Densetsu 2 - Aratanaru Tatakai (J) (v1.0)	饿狼传说1.0(日)
Garou Densetsu 2 - Aratanaru Tatakai (J) (v1.1)	饿狼传说1.1(日)
Garou Densetsu Special (J)	饿狼传说特别版(日)
GD Leen (J) (v1.0)	太空小妖精1.0 (日)
GD Leen (J) (v1.1)	太空小妖精1.01(日)
Gegege no Kitarou - Fukkatsu! Tenma Daiou (J)	鬼太郎(日)
Gekitotsu Dangan Jidousha Kessen - Battle Mobile (J)	激突弹丸自动车决战(日)
Gekitou Burning Pro Wrestling (J)	激斗火焰摔角(日)
Gemfire (U)	独立战争(美)
Genghis Khan II - Clan of the Gray Wolf (U)	元朝秘史2(美)
Genjuu Ryodan (J) (NP)	幻兽旅团(日)(NP)
Genocide 2 (J) (Beta)	灭绝战记(日)(测试版)
Genocide 2 (J)	灭绝战记(日)
George Foreman's KO Boxing (E)	格罗致KO拳击(欧)
George Foreman's KO Boxing (U) (Doritos Promo)	格罗致KO拳击(美) (Doritos Promo)
George Foreman's KO Boxing (U) (v1.0)	格罗致KO拳击1.0(美)
George Foreman's KO Boxing (U) (v1.1)	格罗致KO拳击1.1(美)
Getsumen no Anubis (J)	月面基地(日)
Ghost Chaser Densei (J)	电精(日)
Ghost Sweeper Mikami - Joreishi ha Nice Body (J)	除灵师GS美神(日)
Ghoul Patrol (E)	鬼屋历险(欧)
Ghoul Patrol (J)	鬼屋历险(日)
Ghoul Patrol (U)	鬼屋历险(美)
Gindama Oyakata no Pachinko Hisshouhou (J)
Ginga Eiyuu Densetsu (J)	祇园花(日)
Ginga Sengoku Gunyuuden Rai (J)	银河战国群雄传(日)
Gionbana (J)
Go Go Ackman (J)	冲!冲!恶魔君(日)
Go Go Ackman 2 (J)	冲!冲!恶魔君2(日)
Go Go Ackman 3 (J)	冲!冲!恶魔君3(日)
Go! Go! Dodge League (J) (v1.0)	躲避球小子1.0(日)
Go! Go! Dodge League (J) (v1.1)	躲避球小子1.1(日)
Goal! (U)
Gods (E)	上帝战士(欧)
Gods (U)	上帝战士(美)
Godzilla - Kaijuu Daikessen (J)	哥吉拉-怪兽大决战(日)
Gokinjo Boukentai (J)	近郊冒险队(日)
Gokujou Parodius (J) (Beta)	极上疯狂大射击(日)(测试版)
Gokujou Parodius (J)	极上疯狂大射击(日)
Gon (J)	小恐龙-刚刚君(日)
Goof Troop (E)	高飞狗海贼岛大冒险(欧)
Goof Troop (F)	高飞狗海贼岛大冒险(法)
Goof Troop (G)	高飞狗海贼岛大冒险(德)
Goof Troop (U)	高飞狗海贼岛大冒险(美)
Goofy to Max - Kaizoku Shima no Daibouken (J)
Gouketsuji Ichizoku (J)	豪血寺一族(日)
Gourmet Sentai - Bara Yarou (J)	美食战队(日)
Gousou Jinrai Densetsu - Musya (J)
GP-1 - Part II (U)	GP-1重型机车赛2(美)
GP-1 - Rapid Stream (J)	GP-1行云流水赛(日)
GP-1 (E)	GP-1重型机车赛(欧)
GP-1 (J)	GP-1重型机车赛(日)
GP-1 (U)	GP-1重型机车赛(美)
Gradius III (J)	宇宙巡航舰3(日)
Gradius III (U)	宇宙巡航舰3(美)
Granhistoria - Genshi Sekaiki (J)	幻史世界记 (日)
Great Battle Gaiden 2, The - Matsuri da Wasshoi (J)	SD高达2(日)
Great Battle II, The - Last Fighter Twin (J)	SD英雄之挑战2(日)
Great Battle III, The (J)	SD英雄之挑战3(日)
Great Battle IV, The (J)	SD英雄之挑战4(日)
Great Battle V, The (J)	SD英雄之挑战5(日)
Great Circus Mystery Starring Mickey & Minnie, The (E)	米老鼠-神秘马戏团(欧)
Great Circus Mystery Starring Mickey & Minnie, The (U)	米老鼠-神秘马戏团(美)
Great Waldo Search, The (U)	超级找一找(美)
GT Racing (J)	GT竞速赛车(日)
Gunforce - Battle Fire Engulfed Terror Island (E)	武装部队(欧)
Gunforce - Battle Fire Engulfed Terror Island (J)	武装部队(日)
Gunforce - Battle Fire Engulfed Terror Island (U)	武装部队(美)
Habu Meijin no Omoshiro Shougi (J)
Hagane - The Final Conflict (E)
Hagane - The Final Conflict (U)
Hagane (J) (Beta)	修罗战士-钢-测试版(日)
Hagane (J)	修罗战士-钢(日)
Hai Toride (J)
Haisei Mahjong - Ryouga (J)	牌势麻雀-凌?#123(日)
Hakunetsu Pro Yakyuu - Ganba League (J)	白热野球(日)
Hakunetsu Pro Yakyuu '93 - Ganba League (J) (Beta)	白热野球93-测试版(日)
Hakunetsu Pro Yakyuu '93 - Ganba League (J)	白热野球93 (日)
Hakunetsu Pro Yakyuu '94 - Ganba League 3 (J)
HAL's Hole in One Golf (E)	一杆进洞(欧)
HAL's Hole in One Golf (U)	一杆进洞(美)
Hamelin no Violin Hiki (J)
Hammerlock Wrestling (U)	超魄力摔角(美)
Hana no Keiji - Kumo no Kanata ni (J)	北斗游侠-花之庆次(日)
Hanafuda Ou (J)	花札王(日)
Hanguk Pro Yagu (K)
Hanjuku Hero - Ah, Sekai yo Hanjuku Nare...!! (J)	半熟英雄(日)
Hansei Zaru Jirou-kun no Daibouken (J)	猴子大冒险 (日)
Haou Taikei Ryuu Knight - Lord of Paladin (J)	霸王大系-龙骑士 (日)
Harapeko Bakka (J)	恐龙抢蛋(日)
HardBall III (U)	燃烧野球3(美)
Harley's Humongous Adventure (E)	哈利巨人屋探险(欧)
Harley's Humongous Adventure (U) (Beta)	哈利巨人屋探险-测试版(欧)
Harley's Humongous Adventure (U)	哈利巨人屋探险(美)
Harukanaru Augusta (J)	新3D高尔夫(日)
Harukanaru Augusta 2 - Masters (J)
Harukanaru Augusta 3 - Masters New (J)
Harvest Moon (E)	牧场物语(欧)
Harvest Moon (G)	牧场物语(德)
Harvest Moon (U)	牧场物语(美)
Hashire Hebereke (J)	可爱动物大竞赛(日)
Hat Trick Hero (J)	帽子戏法足球英雄(日)
Hat Trick Hero 2 (J)	帽子戏法足球英雄2(日)
Hatayama Hatch no Pro Yakyuu News! - Jitsumei Ban (J)	实名版棒球 (日)
Hayazashi Nidan Morita Shougi (J)	(2段森田将棋)或(森田将棋2 )(日)
Head-On Soccer (U)	迎头痛击-对决足球 (美)
Hebereke no Oishii Puzzle ha Irimasenka (J)	魔法气泡升官大竞赛 (日)
Hebereke no Popoon (J)	魔法气泡运动大对决 (日)
Hebereke's Popoitto (E)	魔法气泡叠叠乐 (欧)
Hebereke's Popoon (E)	魔法气泡运动大对决(欧)
Heian Fuuunden (J)
Heisei Gunjin Shougi (J)	平成军人将棋-rom版(日)
Heisei Inu Monogatari Bow - Pop'n Smash!! (J)	家有贱狗 (日)
Heisei Shin Onigashima - Kouhen (J)	平成新鬼岛-后篇(日)
Heisei Shin Onigashima - Zenhen (J)	平成新鬼岛-前篇 (日)
Heiwa Pachinko World (J)	柏青哥世界1(日)
Heiwa Pachinko World 2 (J)	柏青哥世界2(日)
Heiwa Pachinko World 3 (J)	柏青哥世界3(日)
Heiwa Parlor! Mini 8 - Pachinko Jikki Simulation Game (J)	8厘米柏青哥实战测试(日)
Hello! Pac-Man (J)	早安!小精灵(日)
Herakles no Eikou III - Kamigami no Chinmoku (J)	斗人魔境传3 (日)
Herakles no Eikou IV - Kamigami Kara no Okurimono (J)	斗人魔境传4 (日)
Hero Senki - Project Olympus (J)	英雄战记 (日)
Hi no Ouji Yamato Takeru (J)
Higashio Osamu Kanshuu - Super Pro Yakyuu Stadium (J)	超级野球(日)
Hiouden - Mamonotachi Tono Chikai (J)	(绯王传？？？)(日)
Hiryuu no Ken S - Golden Fighter (J)	飞龙拳S (日)
Hiryuu no Ken S - Hyper Version (J)	飞龙拳S-加强版(日)
Hissatsu Pachinko Collection (J)	必杀柏青哥1(日)
Hissatsu Pachinko Collection 2 (J)	必杀柏青哥2(日)
Hissatsu Pachinko Collection 3 (J)	必杀柏青哥3(日)
Hissatsu Pachinko Collection 4 (J)	必杀柏青哥4(日)
Hisshou 777 Fighter - Pachi-Slot Ryuuguu Densetsu (J)	必胜777 (日)
Hisshou 777 Fighter II - Pachi-Slot Maruhi Jouhou (J)	必胜777-2 (日)
Hisshou 777 Fighter III - Kokuryuu Ou no Fukkatsu (J)	必胜777-3 (日)
Hisshou Pachi-Slot Fun (J)	必胜水果盘 (日)
Hit the Ice (U)	暴力冰上曲棍球(美)
Hokuto no Ken 5 - Tenma Ryuuseiden Ai Zetsu Shou (J)	北斗神拳5-天魔流星传(日)
Hokuto no Ken 6 - Gekitou Denshou Ken Haou heno Michi (J)	北斗神拳6-霸王之道 (日)
Hokuto no Ken 7 - Seiken Retsuden Denshousha heno Michi (J)	北斗神拳7-圣拳列传(日)
Holy Striker (J)	爆裂斗球-日(日)
Holy Umbrella - Dondera no Mubou!! (J)	光伞传说(日)
Home Alone (E)	小鬼当家(欧)
Home Alone (J)	小鬼当家(日)
Home Alone (U)	小鬼当家(美)
Home Alone 2 - Lost in New York (E)	小鬼当家2 (欧)
Home Alone 2 - Lost in New York (U)	小鬼当家2 (美)
Home Improvement (U)	居家DIY (美)
Honkaku Mahjong - Tetsuman (J)	本格麻雀-徹万 (日)
Honkaku Mahjong - Tetsuman II (J)	本格麻雀-徹万2(日)
Honkaku Shougi - Fuuunji Ryuuou (J)	本格将棋-风云儿龙王(日)
Honkakuha Igo Gosei (J)	基圣(日)
Honke Hanafuda (J)
Honke Sankyo Fever - Jikki Simulation (J)	本家实战机台柏青哥1 (日)
Honke Sankyo Fever 2 - Jikki Simulation (J)	本家实战机台柏青哥2 (日)
Honke Sankyo Fever 3 - Jikki Simulation (J)	本家实战机台柏青哥3 (日)
Honoo no Doukyuuji - Dodge Danpei (J)	火焰斗球儿-弹平(日)
Hook (E)	虎克船长(欧)
Hook (J)	虎克船长(日)
Hook (U)	虎克船长(日)
Hoshi no Kirby - Super Deluxe (J)	超级卡比之星 (日)
Hoshi no Kirby 3 (J)
Houkago in Beppin Jogakuin (J)	放课后 (日)
Hourai Gakuen no Bouken! - Tenkousei Scramble (J)
Human Baseball (J)	休曼棒球(日)
Human Grand Prix (J)	休曼GP赛车1(日)
Human Grand Prix II (J)	休曼GP赛车2(日)
Human Grand Prix III - F1 Triple Battle (J)	休曼GP赛车3 (日)
Human Grand Prix IV - F1 Dream Battle (J)	休曼GP赛车4(日)
Humans, The (E)	人类总动员(欧)
Hungry Dinosaurs (E)	恐龙抢蛋(欧)
Hunt for Red October, The (E)	猎杀红色十月(欧)
Hunt for Red October, The (J)	猎杀红色十月-日(日)
Hunt for Red October, The (U)	猎杀红色十月(美)
Hurricanes (E) (Beta)	飓风足球大进击(欧)(测试版)
Hurricanes (E)	飓风足球大进击(欧)
Hurricanes (U)	飓风足球大进击(美)
Hyper Iria (J)	伊莉雅(日)
Hyper V-Ball (E)	超级排球(欧)
Hyper V-Ball (U)	超级排球(美)
HyperZone (E)	超次元地带-(欧)
HyperZone (J)	超次元地带-(日)
HyperZone (U)	超次元地带-(美)
Idea no Hi (J)	天目伊底亚之日(日)
Ignition Factor, The (U)	救火战士(美)
Igo Club (J)	围棋俱乐部(日)
Ihatov Monogatari (J)	童話物语(日)
Ikari no Yousai (J)	怒之要塞-rom版(日)
Illusion of Gaia (U) (Beta)	盖亚幻想记-测试版(美)
Illusion of Gaia (U)	盖亚幻想记(美)
Illusion of Time (E)	盖亚幻想记 (欧)
Illusion of Time (F)	盖亚幻想记 (法)
Illusion of Time (G)	盖亚幻想记 (德)
Illusion of Time (S)	盖亚幻想记 (西班牙)
Illvanian no Shiro (J)	超魔兽战记(日)
Imperium (U)	超钢战机(美)
Inazuma Serve da! Super Beach Volley (J)	闪电海滩排球 (日)
Incantation (E)	咒语 (欧)
Incantation (U)	咒语 (美)
Incredible Crash Dummies, The (E)	不可思议之人偶(欧)
Incredible Crash Dummies, The (J)	不可思议之人偶-(日)
Incredible Crash Dummies, The (U) (Beta)	不可思议之人偶-测试版(美)
Incredible Crash Dummies, The (U)	不可思议之人偶(美)
Incredible Hulk, The (E)	美国超人之绿巨人(欧)
Incredible Hulk, The (U)	美国超人之绿巨人(美)
Indiana Jones' Greatest Adventures (E)
Indiana Jones' Greatest Adventures (J)
Indiana Jones' Greatest Adventures (U)
Inindo - Way of the Ninja (U)
Inspector Gadget (U)
International Superstar Soccer (E)	G型神探 (欧)
International Superstar Soccer (U)	国际超级明星足球(欧)
International Superstar Soccer Deluxe (E)	国际超级明星足球(美)
International Superstar Soccer Deluxe (U)	国际高级明星足球(欧)
International Tennis Tour (J)	国际高级明星足球(美)
International Tennis Tour (U)	国际网球公开赛-(日)
Ippatsu Gyakuten (J)	国际网球公开赛-(美)
Irem Major Title, The (E)	(一发逆转？？？？？)(日)
Irem Major Title, The (J)
Irem Skins Game, The (U) (NSS)	Irem高尔夫 (美)(NSS)
Irem Skins Game, The (U)	Irem高尔夫(美)
Iron Commando - Koutetsu no Senshi (J)	钢铁战士-(日)
Iron Commando (E) (Beta)	钢铁战士(欧)(测试版)
Isozuri - Ritou Hen (J)	矶钓离岛篇(日)
Itadaki Street 2 - Neon Sign ha Bara Iro ni (J)	创业人生 (日)
Itchy & Scratchy Game, The (E)
Itchy & Scratchy Game, The (U)
Itoi Shigesato no Bass Tsuri No. 1 (J)	系井重里巴斯钓鱼 (日)
Itou Hatasu Rokudan no Shougi Doujou (J)
Izzy's Quest for the Olympic Rings (E)	奥林匹克大进击-(欧)
Izzy's Quest for the Olympic Rings (U) (Beta)	奥林匹克大进击-测试版
Izzy's Quest for the Olympic Rings (U)	奥林匹克大进击-(美)
J.League '96 Dream Stadium (J)
J.League Excite Stage '94 (J)	J联盟热力足球94(日)
J.League Excite Stage '95 (J)	J联盟热力足球95(日)
J.League Excite Stage '96 (J) (v1.0)	J联盟热力足球96-1.0 (日)
J.League Excite Stage '96 (J) (v1.1)	J联盟热力足球96-1.1 (日)
J.League Soccer Prime Goal (J) (v1.0)	J联盟足球得分王-1.0 (日)
J.League Soccer Prime Goal (J) (v1.1)	J联盟足球得分王-1.1 (日)
J.League Soccer Prime Goal 2 (J)	J联盟足球得分王2 (日)
J.League Soccer Prime Goal 3 (J)	J联盟足球得分王3 (日)
J.League Super Soccer (J)	J联盟超级足球 (日)
J.League Super Soccer '95 - Jikkyou Stadium (J)	J联盟超级足球95 (日)
J.R.R. Tolkien's The Lord of the Rings - Volume One (E)
J.R.R. Tolkien's The Lord of the Rings - Volume One (G)
J.R.R. Tolkien's The Lord of the Rings - Volume One (U)
Jack Nicklaus Golf (E)	杰克尼可拉斯高尔夫(欧)
Jack Nicklaus Golf (U)	杰克尼可拉斯高尔夫 (美)
Jaki Crush (J)	邪鬼破坏弹珠台(日)
James Bond Jr. (E)	少年庞德-欧(欧)
James Bond Jr. (U)	少年庞德(美)
James Pond 3 - Operation Starfish (E)	爆笑詹姆斯庞德3 (欧)
James Pond's Crazy Sports (E)	爆笑庞德-疯狂运动会 (欧)
Jammes (J)	骰子方块(日)
Jammit (U)	杰米1对1篮球(美)
Janyuuki - Gokuu Randa (J)
JB The Super Bass (J)
Jelly Boy (E)	杰利小子-欧 (欧)
Jelly Boy 2 (J) (Beta)	杰利小子2(日)测试版
Jeopardy! - Deluxe Edition (U)	电视大问答-高级版(美)
Jeopardy! - Sports Edition (U)	电视大问答-运动版(美)
Jeopardy! (U)	电视大问答(美)
Jerry Boy (J)	史莱姆大进击(日)
Jetsons, The - Invasion of the Planet Pirates (U)	摩登家族
Jigsaw Party (J)	拼图对决(日)
Jikkyou Oshaberi Parodius (J)	实况疯狂大射击(日)
Jikkyou Power Pro Wrestling '96 - Max Voltage (J)
Jikkyou Powerful Pro Yakyuu - Basic Ban '98 (J)	实况野球98(日)
Jikkyou Powerful Pro Yakyuu 2 (J)	实况野球2(日)
Jikkyou Powerful Pro Yakyuu 3 - '97 Haru (J) (v1.0)
Jikkyou Powerful Pro Yakyuu 3 - '97 Haru (J) (v1.1)
Jikkyou Powerful Pro Yakyuu 3 (J)	实况野球3(日)
Jikkyou Powerful Pro Yakyuu '94 (J)	实况野球94(日)
Jikkyou Powerful Pro Yakyuu '96 - Kaimaku Ban (J) (v1.0)	实况野球96-1.0(日)
Jikkyou Powerful Pro Yakyuu '96 - Kaimaku Ban (J) (v1.1)	实况野球96-1.0 (日)
Jikkyou World Soccer - Perfect Eleven (J)	实况世界足球(日)
Jikkyou World Soccer 2 - Fighting Eleven (J) (Beta)	实况世界足球2(日)测试版
Jikkyou World Soccer 2 - Fighting Eleven (J)	实况世界足球2(日)
Jim Lee's WildC.A.T.S - Covert Action Teams (U)
Jim Power - The Lost Dimension in 3D (E)	吉姆大展神威-欧(欧)
Jim Power - The Lost Dimension in 3D (U)	吉姆大展神威(美)
Jimmy Connors Pro Tennis Tour (E)	吉米可诺专业网球(欧)
Jimmy Connors Pro Tennis Tour (F)	吉米可诺专业网球(法)
Jimmy Connors Pro Tennis Tour (G)	吉米可诺专业网球(德)
Jimmy Connors Pro Tennis Tour (J)	吉米可诺专业网球(日)
Jimmy Connors Pro Tennis Tour (U)	吉米可诺专业网球(美)
Jimmy Houston's Bass Tournament U.S.A. (U)	实战巴斯钓鱼必胜法(美)
Jissen Bass Fishing Hisshouhou in USA (J)
Jissen Kyoutei (J)
Jissen Pachinko Hisshouhou! 2 (J)
Jissen! Mahjong Shinan (J)
Jissen! Pachi-Slot Hisshouhou! (J)	实战777必胜法(日)
Jissen! Pachi-Slot Hisshouhou! 2 (J)	实战777必胜法2(日)
Jissen! Pachi-Slot Hisshouhou! Classic (J)	实战777无敌必胜法(日)
Jissen! Pachi-Slot Hisshouhou! Twin (J)	实战777必胜法(日)
Jissen! Pachi-Slot Hisshouhou! Twin Vol. 2 (J)	实战777必胜法(日)
Jissen! Pachi-Slot Hisshouhou! Yamasa Densetsu (J)	777必胜法-山佐传说(日)
Joe & Mac - Caveman Ninja (E) (M6) (Beta)	战斗原始人(欧) (M6) (测试版)
Joe & Mac - Caveman Ninja (E) (M6)	战斗原始人(欧)(M6)
Joe & Mac - Tatakae Genshijin (J)	战斗原始人(日)
Joe & Mac (U)	战斗原始人(美)
Joe & Mac 2 - Lost in the Tropics (U) (Beta)	战斗原始人2(美)(测试版)
Joe & Mac 2 - Lost in the Tropics (U)	战斗原始人2(美)
Joe & Mac 3 - Lost in the Tropics (E) (M3) (Beta)	战斗原始人3(欧)(测试版)
Joe & Mac 3 - Lost in the Tropics (E) (M3)	战斗原始人3(欧)
John Madden Football (U)
John Madden Football '93 (E)
John Madden Football '93 (U) (v1.0)
John Madden Football '93 (U) (v1.1)
Jojo no Kimyou na Bouken (J)	JOJO冒险野郎(日)
Joushou Mahjong Tenpai (J)
Judge Dredd (E)	超时空战警(欧)
Judge Dredd (J)	超时空战警(日)
Judge Dredd (U) (Sample)	超时空战警(美)(Sample)
Judge Dredd (U)	超时空战警(美)
Jumbo Ozaki no Hole in One (J)	尾崎高尔夫(日)
Jumpin' Derby (J)	德贝赛马王(日)
Jungle Book, The (E)	丛林王子(欧)
Jungle Book, The (J)	丛林王子(日)
Jungle Book, The (U) (Beta)	丛林王子(美)(测试版)
Jungle Book, The (U)	丛林王子(美)
Jungle no Ouja Ta-chan - Sekaimanyuu Daikakutou no Maki (J)
Jungle Strike (E)	丛林激战直升机(欧)
Jungle Strike (J)	丛林激战直升机(日)
Jungle Strike (U)	丛林激战直升机(美)
Jungle Wars 2 - Kodai Mahou Ateimos no Nazo (J)	丛林大战2(日)
Jurassic Park (E) (Beta)	侏罗纪公园(欧)(测试版)
Jurassic Park (E)	侏罗纪公园(欧)
Jurassic Park (F)	侏罗纪公园(法)
Jurassic Park (G)	侏罗纪公园(德)
Jurassic Park (I)	侏罗纪公园(I)
Jurassic Park (J)	侏罗纪公园(日)
Jurassic Park (S)	侏罗纪公园(西班牙)
Jurassic Park (U) (v1.0)	侏罗纪公园(美)1.0
Jurassic Park (U) (v1.1)	侏罗纪公园(美)1.1
Jurassic Park II - The Chaos Continues (E) (M4)	侏罗纪公园2(欧)(M4)
Jurassic Park II - The Chaos Continues (U) (M4) (Beta)	侏罗纪公园2(美)(M4)测试版
Jurassic Park II - The Chaos Continues (U) (M4)	侏罗纪公园2(美)
Justice League Task Force (E)	正义超人大对决(欧)
Justice League Task Force (J)	正义超人大对决(日)
Justice League Task Force (U)	正义超人大对决(美)
Jutei Senki (J)	树帝战记(日)
JWP Joshi Pro Wrestling - Pure Wrestle Queens (J)	JWP女子摔角皇后(日)
K.H. Rummenigge's Player Manager (G) (Sample)	KH足球经纪人(德)(Sample)
K.H. Rummenigge's Player Manager (G)	KH足球经纪人(德)
Kablooey (U)	爆破精灵(美)
Kabuki Chou Reach Mahjong Tonpuusen (J)
Kabuki Rocks (J)	歌舞妓洛克斯(日)
Kachou Shima Kousaku (J)
Kagakusha Harley no Haran Banjou (J)	哈利巨人屋探险(日)
Kaite Tsukutte Asoberu Dezaemon (J)	描绘卫门(日)
Kakinoki Shougi for Super Famicom (J)
Kamaitachi no Yoru (J)	恐怖惊魂夜(日)
Kamen Rider (J)	假面骑士(日)
Kamen Rider SD - Shutsugeki!! Rider Machine (J)	SD假面骑士(日)
Karura Ou (J)	迦楼罗王(日)
Kashiwagi Shigetaka no Top Water Bassing (J)	頂尖钓客(日)
Katou Hifumi Kudan - Shougi Club (J)
Kat's Run - Zen-Nihon K-Car Senshuken (J)	车神大赛(日)
Kawa no Nushi Tsuri 2 (J)	钓鱼太郎2(日)
Kawasaki Caribbean Challenge (U)	川崎竞速挑战(美)
Kawasaki Superbike Challenge (E)	川崎超级机车赛(欧)
Kawasaki Superbike Challenge (U)	川崎超级机车赛(美)
Keeper (J)	奇波方块(日)
Keiba Eight Special (J) (v1.0)	马券买入术(日)1.0
Keiba Eight Special (J) (v1.1)	马券买入术(日)1.1
Keiba Eight Special 2 (J)	马券买入术2(日)
Ken Griffey Jr. Presents Major League Baseball (U)
Ken Griffey Jr.'s Winning Run (U)	小葛瑞非热战全场(美)
Kendo Rage (U)	狂暴剑道(美)
Kentou Ou World Champion (J)	拳斗王(日)
Kenyuu Densetsu Yaiba (J)	剑勇传说(日)
Kero Kero Keroppi no Bouken Nikki - Nemureru Mori no Keroriinu (J)	大眼蛙的冒险日记(日)
Kessen! Dokapon Oukoku IV - Densetsu no Yuushatachi (J)	多卡波王国4(日)
Kevin Keegan's Player Manager (E)	凯文的足球经纪人(欧)
Kick Off (E)	劲射入网(欧)
Kick Off 3 - European Challenge (E) (Beta)	欧洲足球挑战赛3(欧)(测试版)
Kick Off 3 - European Challenge (E) (M5)	欧洲足球挑战赛3(欧)(M5)
Kid Klown in Crazy Chase (E)	凯伦的疯狂追逐(欧)
Kid Klown in Crazy Chase (U)	凯伦的疯狂追逐(美)
Kid Klown no Crazy Chase (J)	凯伦的疯狂追逐(日)
Kidou Butouden G-Gundam (J)	机动武斗传G(日)
Kidou Senshi Gundam - Cross Dimension 0079 (J)
Kidou Senshi Gundam F91 - Formula Senki 0122 (J)
Kidou Senshi V-Gundam (J)	机动战士-高达V(日)
Kidou Senshi Z-Gundam - Away to the Newtype (J)	机动战士-高达Z (日)
Kidou Soukou Dion (J)	超钢战机-机动装甲(日)
Kidoukeisatsu Patlabor (J)	机动警察(日)
Kigurumi Daibouken - Dream Maze (J)
Kiki Kaikai - Nazo no Kuro Manteau (J)
Kiki Kaikai - Tsukiyo Soushi (J)
Kikou Keisatsu Metal Jack (J)
Kikuni Masahiko no Jantoushi Doraou (J)
Kikuni Masahiko no Jantoushi Doraou 2 - Kigyou Senshi (J)
Killer Instinct (E)
Killer Instinct (U) (Beta)
Killer Instinct (U) (v1.0)
Killer Instinct (U) (v1.1)
Kindai Mahjong Special (J)
King Arthur & The Knights of Justice (U)
King Arthur's World (E)
King Arthur's World (U) (Beta)
King Arthur's World (U)
King of Dragons, The (J)
King of Dragons, The (U)
King of Rally, The (J)
King of the Monsters (E)	万兽之王(欧)
King of the Monsters (J)	万兽之王(日)
King of the Monsters (U)	万兽之王(美)
King of the Monsters 2 - The Next Thing (J)	万兽之王2(日)
King of the Monsters 2 (U)	万兽之王2(美)
Kingyo Chuuihou! Tobidase! Game Gakuen (J)	金鱼学园(日)
Kinnikuman - Dirty Challenger (J)
Kirby Bowl (J)	卡比滚球(日)
Kirby no Kirakira Kids (J) (NP)	卡比方块(日)
Kirby Super Star (U)	卡比超级之星(美)
Kirby's Avalanche (U)	卡比魔法气泡(美)
Kirby's Dream Course (E)	卡比滚球(欧)
Kirby's Dream Course (U)	卡比滚球(美)
Kirby's Dream Land 3 (U)	卡比梦幻岛3(美)
Kirby's Fun Pak (E)
Kirby's Ghost Trap (E)	卡比魔法气泡(欧)
Kishin Douji Zenki - Battle Raiden (J)	鬼神童子-烈斗雷传(日)
Kishin Douji Zenki - Denei Raibu (J)	鬼神童子-电影雷舞(日)
Kishin Douji Zenki - Tenchi Meidou (J)	鬼神童子-天地鸣动(日)
Kishin Kourinden Oni (J) [1C74]	鬼神降临传(日)
Kishin Kourinden Oni (J) [ACC6]	鬼神降临传(日)
Kiteretsu Daihyakka - Choujikuu Sugoroku (J)	奇天烈大百科大富翁(日)
Knights of the Round (J)	圆桌骑士-日(日)
Knights of the Round (U)	圆桌骑士(美)
Konpeki no Kantai (J)	绀碧之舰队 (日)
Kouryaku Casino Bar (J)	赌城大攻略(日)
Kouryuu Densetsu Villgust - Kieta Shoujo (J)
Kouryuu no Mimi (J)	黄龙之耳(日)
Kouryuuki (J)	項刘记
Koushien 2 (J)	甲子园2(日)
Koushien 3 (J)	甲子园3(日)
Koushien 4 (J)	甲子园4(日)
Kousoku Shikou - Shougi Ou (J)	将棋皇(日)
Koutetsu no Kishi (J)	钢铁之骑士1(日)
Koutetsu no Kishi 2 - Sabaku no Rommel Gundan (J)	钢铁之骑士2(日)
Koutetsu no Kishi 3 - Gekitotsu Europe Sensen (J)	钢铁之骑士3(日)
Krusty's Super Fun House (E)
Krusty's Super Fun House (U) (v1.0)
Krusty's Super Fun House (U) (v1.1)
Krusty's World (J)
Kunio no Oden (J)	热血食物方块(日)
Kunio-kun no Dodge Ball dayo Zenin Shuugou! - Tournament Special (J)
Kunio-kun no Dodge Ball dayo Zenin Shuugou! (J)
Kuusou Kagaku Sekai Gulliver Boy (J)	空想科学世界(日)
Kyle Petty's No Fear Racing (U)	凯勒劲爆赛车(美)
Kyuuyaku Megami Tensei (J)
Lady Stalker - Kako Kara no Chousen (J)	秘境魔宝美少女篇(日)
Lagoon (E)	礁湖传说(欧)
Lagoon (G)	礁湖传说(德)
Lagoon (J)	礁湖传说(日)
Lagoon (U)	礁湖传说-美(美)
Lamborghini - American Challenge (E)	宝基尼-美国挑战(欧)
Lamborghini - American Challenge (U)	宝基尼-美国挑战(美)
Langrisser, Der (J) (v1.0)
Langrisser, Der (J) (v1.1)
Laplace no Ma (J)
Larry Nixon's Super Bass Fishing (J)	賴瑞超级黑巴斯钓鱼(日)
Las Vegas Dream (J)	拉斯维加斯之梦(日)
Last Action Hero (E)	最后魔鬼英雄(欧)
Last Action Hero (U)	最后魔鬼英雄(美)
Last Battle, The (J)	最后决战(日)
Last Bible III (J)	最后的圣经3(日)
Lawnmower Man, The (E)	剪草人(欧)
Lawnmower Man, The (U) (Beta)	剪草人(美)测试版
Lawnmower Man, The (U)	剪草人(美)
Leading Company (J)	株式会社经营(日)
Leading Jockey (J)	马场大亨(日)
Leading Jockey 2 (J)	马场大亨2(日)
Legend (E)	传说战士(欧)
Legend (U) [02CE]	传说战士(美)[02CE]
Legend (U) [4155]	传说战士(美)[4155]
Legend of the Mystical Ninja, The (E)
Legend of the Mystical Ninja, The (G)
Legend of the Mystical Ninja, The (U)
Legend of Zelda, The - A Link to the Past (E)	萨尔达传说(欧)
Legend of Zelda, The - A Link to the Past (F)	萨尔达传说(法)
Legend of Zelda, The - A Link to the Past (FC)	萨尔达传说-(法)
Legend of Zelda, The - A Link to the Past (G)	萨尔达传说(德)
Legend of Zelda, The - A Link to the Past (U)	萨尔达传说(美)
Lemmings (E)	旅鼠总动员(欧)
Lemmings (J)	旅鼠总动员(日)
Lemmings (U) (v1.0)	旅鼠总动员(美)(v1.0)
Lemmings (U) (v1.1)	旅鼠总动员(美)(v1.1)
Lemmings 2 - The Tribes (E)	旅鼠总动员2(欧)
Lemmings 2 - The Tribes (J)	旅鼠总动员2(日)
Lemmings 2 - The Tribes (U)	旅鼠总动员2(美)
Lennus - Kodai Kikai no Kioku (J)	魔星迷踪(日)
Lennus II - Fuuin no Shito (J)	魔星迷踪2(日)
Lester the Unlikely (U)	惊异之旅(美)
Lethal Enforcers (E)	双枪-欧(枪)
Lethal Enforcers (J)	双枪-日(枪)
Lethal Enforcers (U)	双枪-美(枪)
Lethal Weapon (E)	致命武器
Lethal Weapon (U) (NSS)	致命武器
Lethal Weapon (U)	致命武器
Libble Rabble (J)	超级连一连
Liberty or Death (U)	独立战争(美)
Light Fantasy (J)	光之传说(日)
Light Fantasy II (J)	光之传说2(日)
Lion King, The (E)	狮子王(欧)
Lion King, The (J)	狮子王(日)
Lion King, The (U)	狮子王(美)
Little Magic (J) (Beta)	小小魔法师(日)测试版
Little Magic (J)	小小魔法师(日)
Little Master - Nijiiro no Maseki (J)	魔兽大战-虹色之魔石(日)
Live-A-Live (J)	狂飙骑士(日)
Lock On (U)	锁定目标(美)
Lode Runner Twin - Justy to Liberty no Daibouken (J)	掏金大冒险(日)
Lodoss-tou Senki (J)	罗德斯岛战记(日)
Logos Panic Goaisatsu (J)
Looney Tunes - Road Runner vs Wile E. Coyote (J)
Looney Tunes Basketball (E)	迪士尼卡通明星篮球(欧)
Looney Tunes B-Ball (U)	迪士尼卡通明星篮球(美)
Lord Monarch (J)	领土统治战(日)
Lost Vikings II, The (E) (M3)	太空维京人2(欧)(M3)
Lost Vikings II, The (U)	太空维京人2(美)
Lost Vikings, The (E)	太空维京人(欧)
Lost Vikings, The (G)	太空维京人(德)
Lost Vikings, The (S)	太空维京人(西班牙)
Lost Vikings, The (U) (Beta)	太空维京人(美)测试版
Lost Vikings, The (U)	太空维京人(美)
Lothar Matthaus Super Soccer (G)	马拉度那超级足球(德)
Love Quest (J)	恋爱日记(日)
Lucky Luke (E) (M4)	幸运路克-西部大枪战(欧)(M4)
Lufia & The Fortress of Doom (U)
Lufia (E)	四狂神战记(欧)
Lufia (G)	四狂神战记(德)
Lufia (NL)	四狂神战记(NL)
Lufia (S)	四狂神战记(西班牙)
Lufia II - Rise of the Sinistrals (U)	四狂神战记2(美)
Lupin Sansei - Densetsu no Hihou wo Oe! (J)	鲁邦三世(日)
M.A.C.S. Basic Rifle Marksmanship (U)
Madden NFL '94 (E)	约翰马顿美式足球94-(欧)
Madden NFL '94 (U)	约翰马顿美式足球94-美
Madden NFL '95 (E)	约翰马顿美式足球95(欧)
Madden NFL '95 (U)	约翰马顿美式足球95(美)
Madden NFL '96 (U) (Sample)	约翰马顿美式足球96(美)(Sample)
Madden NFL '96 (U)	约翰马顿美式足球96(美)
Madden NFL '97 (U)	约翰马顿美式足球97(美)
Madden NFL '98 (U)	约翰马顿美式足球98(美)
Madou Monogatari - Hanamaru Daiyouchienji (J)	魔导物语-大幼稚园儿(日)
Maerchen Adventure Cotton 100% (J)
Magic Boy (E) (Beta)	魔法男孩(欧)测试版
Magic Boy (E)	魔法男孩(欧)
Magic Boy (U)	魔法男孩(美)
Magic Johnson no Super Slam Dunk (J)	魔术强森的超级灌篮(日)
Magic Knight Rayearth (J)	魔法骑士-雷阿斯(日)
Magic Sword (E)	魔剑(欧)
Magic Sword (J)	魔剑(日)
Magic Sword (U)	魔法堆球(日)
Magical Drop (J)	魔法堆球(日)
Magical Drop 2 (J)	魔法堆球2(日)
Magical Pop'n (J)	魔法大进击(日)
Magical Quest Starring Mickey Mouse, The (E)
Magical Quest Starring Mickey Mouse, The (G) (v1.0)
Magical Quest Starring Mickey Mouse, The (G) (v1.1)
Magical Quest Starring Mickey Mouse, The (U) (Beta)
Magical Quest Starring Mickey Mouse, The (U)
Magical Taruruuto-kun - Magic Adventure (J)
Magna Braban - Henreki no Yuusha (J)	魔法与剑(日)
Mahjong Club (J)	麻雀俱乐部(日)
Mahjong Gokuu Tenjiku (J)	麻雀繁盛记(日)
Mahjong Hanjouki (J)	麻雀繁盛记(日)
Mahjong Sengoku Monogatari (J)	麻雀战国物语(日)
Mahjong Taikai II (J)	麻雀大会2(日)
Mahjong Touhaiden, The (J)	麻雀斗牌传(日)
Mahou Poi Poi Poitto! (J)	魔法转转叠(日)
Mahoujin Guruguru (J)	魔法阵咕噜咕噜(日)
Mahoujin Guruguru 2 (J)	魔法阵咕噜咕噜2(日)
Majin Tensei (J) (v1.0)	魔神转生1-1.0(日)
Majin Tensei (J) (v1.1)	魔神转生1-1.1(日)
Majin Tensei (J) (v1.2)	魔神转生1-1.2(日)
Majin Tensei II - Spiral Nemesis (J)	魔神转生2(日)
Majotachi no Nemuri (J)	沉睡的魔女(日)
Majuu Ou (J)	魔兽王(日)
Maka Maka (J)	魔诃魔诃(日)
Makeruna! Makendou (J)	魔剑道(日)
Makeruna! Makendou 2 - Kimero! Youkai Souridaijin (J)	魔剑道2(日)
Manchester United Championship Soccer (E) (Beta)	曼徹斯特冠军足球赛(欧)测试版
Manchester United Championship Soccer (E)	曼徹斯特冠军足球赛 (欧)
Mario & Wario (J)	马力欧与瓦力欧(日)
Mario is Missing! (E)	马力欧失踪记(欧)
Mario is Missing! (F)	马力欧失踪记(法)
Mario is Missing! (G)	马力欧失踪记(美)
Mario is Missing! (U)	马力欧失踪记(美)
Mario no Super Picross (J)	马力欧超级敲方块(日)
Mario Paint (E)	马力欧绘图(欧)
Mario Paint (JU)	马力欧绘图(日美)
Mario's Early Years! - Fun with Letters (U)	马力欧学前教育-字母篇 (美)
Mario's Early Years! - Fun with Numbers (U)	马力欧学前教育-数字篇 (美)
Mario's Early Years! - Preschool Fun (U)	马力欧学前教育-幼稚园(美)
Mario's Time Machine (E)	马力欧的时光机器(欧)
Mario's Time Machine (G)	马力欧的时光机器(德)
Mario's Time Machine (U)	马力欧的时光机器(美)
Mark Davis' The Fishing Master (U)	麦克大卫钓鱼大师(美)
Marko's Magic Football (E) (M4)	马可的魔法足球(欧)(M4)
Marmalade Boy (J)	甜蜜男孩(日)
Marvel Super Heroes - War of the Gems (E)	美国超人-秘宝之战(欧)
Marvel Super Heroes - War of the Gems (J)	美国超人-秘宝之战(日)
Marvel Super Heroes - War of the Gems (U)	美国超人-秘宝之战(美)
Marvelous - Mouhitotsu no Takarajima (J)	奇异-猴子们的宝岛(日)
Mary Shelley's Frankenstein (U) (Beta)
Mary Shelley's Frankenstein (U)
Mask, The (E)	摩登大圣(欧)
Mask, The (J)	摩登大圣(日)
Mask, The (U) (Beta)	摩登大圣(美)(测试版)
Mask, The (U)	摩登大圣(美)
Maten Densetsu - Senritsu no Ooparts (J)	魔天传说(日)
Math Blaster - Episode One (U)	数字射击(美)
Matsukata Hiroki no Super Trolling (J)	松方弘树的超级钓鱼(日)
Matsumura Kuni Hiroden - Saikyou no Rekishi wo Nurikaero! (J)	松村邦洋传(日)
Maui Mallard in Cold Shadow (U)
Mazinger Z (J) [3D7F]	无敌铁金刚Z(日)[3D7F]
Mazinger Z (J) [7144]	无敌铁金刚Z(日)[7144]
Mecarobot Golf (U)	机器人高尔夫(美)
Mechwarrior (E)	机甲战记(欧)
Mechwarrior (F)	机甲战记(法)
Mechwarrior (G)	机甲战记(德)
Mechwarrior (S)	机甲战记(西班牙)
Mechwarrior (U)	机甲战记(美)
Mechwarrior 3050 (E)	机甲争霸3050(欧)
Mechwarrior 3050 (U)	机甲争霸3050(美)
Mega lo Mania - Jikuu Daisenryaku (J)	诸神领地战(日)
Mega lo Mania (E) (M3)	诸神领地战(欧)(M3)
Megaman VII (E)	洛克人7(欧)
Megaman VII (U)	洛克人7(美)
Megaman X (E)	洛克人X(欧)
Megaman X (U) (v1.0)	洛克人X(美)1.0版
Megaman X (U) (v1.1)	洛克人X(美)1.1版
Megaman X2 (E)	洛克人X2(欧)
Megaman X2 (U)	洛克人X2(美)
Megaman X3 (E)	洛克人X3(欧)
Megaman X3 (U)	洛克人X3(美)
Megaman's Soccer (U)
Melfand Stories (J)	美法蘭传说(日)
Metal Combat - Falcon's Revenge (E)
Metal Combat - Falcon's Revenge (U)
Metal Marines (E)	金属战队(欧)
Metal Marines (U)	金属战队(美)
Metal Max 2 (J)	坦克战记2(日)
Metal Max Returns (J)	坦克战记3(日)
Metal Morph (U)	液态金属战士(美)
Metal Slader Glory - Director's Cut (J)	金属之光(日)
Metal Warriors (U)	金属机器人战记(美)
Michael Andretti's IndyCar Challenge (J)	麦可印地安赛车(日)
Michael Andretti's IndyCar Challenge (U)	麦可印地安赛车(美)
Michael Jordan - Chaos in the Windy City (E)	麦可乔登历险记(欧)
Michael Jordan - Chaos in the Windy City (U)	麦可乔登历险记(美)
Mick & Mack as the Global Gladiators (U) (Beta) [1829][h]	米克与麦可(美)测试版
Mick & Mack as the Global Gladiators (U) (Beta) [71AB][h]	米克与麦可(美)测试版
Mickey Mania - The Timeless Adventures of Mickey Mouse (E)	米老鼠迷(欧)
Mickey Mania - The Timeless Adventures of Mickey Mouse (J)	米老鼠迷(日)
Mickey Mania - The Timeless Adventures of Mickey Mouse (U)	米老鼠迷(美)
Mickey no Magical Adventure (J) (v1.0)	米老鼠-魔法传说(日)1.0
Mickey no Magical Adventure (J) (v1.1)	米老鼠-魔法传说(日)1.1
Mickey no Tokyo Disneyland Daibouken (J)
Mickey to Donald - Magical Adventure 3 (J)
Mickey to Minnie - Magical Adventure 2 (J)
Mickey's Playtown Adventure - A Day of Discovery! (U) (Beta)	米老鼠游乐城冒险(美)(测试版)
Mickey's Ultimate Challenge (U)	米老鼠的终极挑战(美)
Micro Machines (E)	微形机器(美)
Micro Machines (U)	微形机器(美)
Micro Machines 2 - Turbo Tournament (E)	微形机器2(欧)
Might and Magic - Book Two (J)
Might and Magic II - Gates to Another World (E)	魔法门2(欧)
Might and Magic II - Gates to Another World (G)	魔法门2(德)
Might and Magic III - Isles of Terra (U) (Beta)	魔法门3(美)测试版
Might and Magic III - Isles of Terra (U)	魔法门3(美)
Mighty Max (E)	万能麦斯(欧)
Mighty Max (U) (Beta)	万能麦斯(美)(Beta)
Mighty Max (U)	万能麦斯(美)
Mighty Morphin Power Rangers - The Fighting Edition (E)	恐龙战队-金刚对决(欧)
Mighty Morphin Power Rangers - The Fighting Edition (U)	恐龙战队-金刚对决(美)
Mighty Morphin Power Rangers - The Movie (E)
Mighty Morphin Power Rangers - The Movie (U)
Mighty Morphin Power Rangers (E)	恐龙战队(欧)
Mighty Morphin Power Rangers (J)	恐龙战队-(日)
Mighty Morphin Power Rangers (U)	恐龙战队(美)
Milandra (J)	米蘭达拉传说
Militia (J)	金属战队-(日)
Mini Yonku Let's & Go!! - Power WGP 2 (J) (NP)	爆走兄弟2(日)(NP)
Mini Yonku Shining Scorpion - Let's & Go!! (J)	四驱车向前走(日)
Miracle Casino Paradise (J)	神奇赌博天堂(日)
Miracle Girls (J)	神奇女孩(日)
Miracle Piano Teaching System, The (U)
Miyaji Shachou no Pachinko Fan - Shouri Sengen 2 (J)
Mizuki Shigeru no Youkai Hyakkiyakou (J)
MLBPA Baseball (U)	美商艺电棒球(美)
Mohawk & Headphone Jack (E)	刺蝟超人魔哈克(欧)
Mohawk & Headphone Jack (U)	刺蝟超人魔哈克(美)
Monopoly (J)	大富翁(日)
Monopoly (U) (v1.0)	大富翁(美)1.0
Monopoly (U) (v1.1)	大富翁(美)1.1
Monopoly Game 2, The (J)	大富翁2(日)
Monstania (J)	怪物圣地(日)
Monster Maker III - Hikari no Majutsushi (J)	怪兽制造厂3(日)
Monster Maker Kids - Ousama ni Naritai (J)	怪兽制造厂-小孩版(日)
Mortal Kombat - Shinken Kourin Densetsu (J)
Mortal Kombat (E) (Beta)	真人快打(欧)
Mortal Kombat (E)	真人快打(欧)
Mortal Kombat (U)	真人快打(美)
Mortal Kombat 3 (E) (Beta)	真人快打3(欧)测试版
Mortal Kombat 3 (E)	真人快打3(欧)
Mortal Kombat 3 (U) (Beta)	真人快打3(美)
Mortal Kombat 3 (U)	真人快打3(美)
Mortal Kombat II - Kyuukyoku Shinken (J)
Mortal Kombat II (E) (v1.0)	真人快打2(欧)(1.0)
Mortal Kombat II (E) (v1.1)	真人快打2(欧)(1.1)
Mortal Kombat II (U) (v1.0)	真人快打2(美)(1.0)
Mortal Kombat II (U) (v1.1)	真人快打2(美)(1.1)
Mother 2 - Gyiyg no Gyakushuu (J)	地球冒险2(日)
Motoko-chan no Wonder Kitchen (J)	城子的廚房(日)
Motteke Oh! Dorobou (J)	快乐人生(日)
Mouryou Senki Madara 2 (J)	魍魉战记2(日)
Mr Nutz (E) (M2)	松鼠大冒险(欧)(M2)
Mr Nutz (J)	松鼠大冒险(日)
Mr Nutz (U) (M2) (Beta)	松鼠大冒险(美)(M2) (测试版)
Mr Nutz (U) (M2)	松鼠大冒险(美)(M2)
Mr. Do! (E)	度!先生(欧)
Mr. Do! (J)	度!先生(日)
Mr. Do! (U)	度!先生(美)
Mr. Tuff (E) (M5) (Beta)	巖球先生(欧)(M5) (测试版)
Ms. Pac-Man (E)	小精灵小姐(欧)
Ms. Pac-Man (U)	小精灵小姐(美)
Muhammad Ali Heavyweight Boxing (U) (Beta)	拳王阿里(美)测试版
Mujintou Monogatari (J)	无人岛物语(日)
Multi Play Volleyball (J)	多人排球(日)
Muscle Bomber - The Body Explosion (J)	霸王摔角(日)
Musya (U)	豪枪神雷传说(美)
Mystery Circle (J)	神秘绕圈方块(日)
Mystic Ark (J)	惑星引导者2/神秘的约柜(日)
Mystic Quest Legend (E)	最终幻想外传(欧)
Mystic Quest Legend (F)	最终幻想外传(法)
Mystic Quest Legend (G)	最终幻想外传(德)
Nage Libre - Seijaku no Suishin (J)	女子学园社团战记(日)
Nakajima Satoru Kanshuu F-1 Hero '94 (J)	F1英雄94(日)
Nakano Kouichi Kanshuu - Keirin Ou (J)	竞轮王(日)
Naki no Ryuu - Mahjong Hishouden (J)
Namcot Open (J)	拿姆科高尔夫开打(日)
Nangoku Shounen Papuwa-kun (J)	南国少年-奇小邪(日)
Naruhodo! The World (J)	原来如此!世界问答比赛(日)
Natsuki Crisis Battle (J)	空手女神龙-日(日)
Natsume Championship Wrestling (U)	全日本摔角(美)
NBA All-Star Challenge (E)	NBA全美明星挑战赛(欧)
NBA All-Star Challenge (J)	NBA全美明星挑战赛(日)
NBA All-Star Challenge (U)	NBA全美明星挑战赛(美)
NBA Give 'n Go (E)	实战NBA篮球(欧)
NBA Give 'n Go (U)	实战NBA篮球(美)
NBA Hang Time (E)	NBA篮球-中场时刻(欧)
NBA Hang Time (U)	NBA篮球-中场时刻(美)
NBA Jam - Tournament Edition (E)	劲爆NBA篮球-竞技(欧)
NBA Jam - Tournament Edition (J)	劲爆NBA篮球-竞技(日)
NBA Jam - Tournament Edition (U) (Beta)	劲爆NBA篮球-竞技(美)测试版
NBA Jam - Tournament Edition (U)	劲爆NBA篮球-竞技(美)
NBA Jam (E) (v1.0)	劲爆NBA篮球(欧)(v1.0)
NBA Jam (E) (v1.1)	劲爆NBA篮球(欧)(v1.1)
NBA Jam (J)	劲爆NBA篮球(日)
NBA Jam (U) (v1.0)	劲爆NBA篮球(美)(v1.0)
NBA Jam (U) (v1.1)	劲爆NBA篮球(美)(v1.1)
NBA Jikkyou Basket Winning Dunk (J)	NBA实况?#123;球赛 (日)
NBA Live '95 (E)	NBA现场直播赛95(欧)
NBA Live '95 (J)	NBA现场直播赛95(日)
NBA Live '95 (U)	NBA现场直播赛95(美)
NBA Live '96 (E)	NBA现场直播赛96(欧)
NBA Live '96 (U)	NBA现场直播赛96(美)
NBA Live '97 (E)	NBA现场直播赛97(欧)
NBA Live '97 (U)	NBA现场直播赛97(美)
NBA Live '98 (U)	NBA现场直播赛98(美)
NBA Pro Basketball - Bulls vs Blazers (J)	NBA专业篮球-Bulls vs.Blazers(日)
NBA Pro Basketball '94 - Bulls vs Suns (J)	NBA专业篮球94-Bulls vs. Suns(日)
NBA Showdown (U) (Beta)	NBA篮球-最后王牌(美)测试版
NBA Showdown (U)	NBA篮球-最后王牌(美)
NCAA Basketball (U) (Beta)	美国大学篮球(美)测试版
NCAA Basketball (U) (NSS)	美国大学篮球(美) (NSS)
NCAA Basketball (U) (v1.0)	美国大学篮球(美)(v1.0)
NCAA Basketball (U) (v1.1)	美国大学篮球(美)(v1.1)
NCAA Final Four Basketball (U)	美国大学篮球-最后时刻(美)
NCAA Football (U)	美国大学足球赛(美)
Nekketsu Tairiku Burning Heroes (J)	热血大陆(日)
Network Q Rally (U) (Beta)
Neugier - Umi to Kaze no Kodou (J)
New Yatterman - Nandai Kandai Yajirobee (J)	新亚达超人(日)
Newman-Haas IndyCar Racing featuring Nigel Mansell (E)	新人类印地安赛车(欧)
Newman-Haas IndyCar Racing featuring Nigel Mansell (J)	新人类印地安赛车(日)
Newman-Haas IndyCar Racing featuring Nigel Mansell (U)	新人类印地安赛车(美)
NFL Football (J)	NFL美式足球(日)
NFL Football (U)	NFL美式足球(美)
NFL Pro Football '94 (J)	NFL专业美式足球94(日)
NFL Quarterback Club (E)	NFL四分卫俱乐部(欧)
NFL Quarterback Club (J)	NFL四分卫俱乐部(日)
NFL Quarterback Club (U) (Beta)	NFL四分卫俱乐部(美)(测试版)
NFL Quarterback Club (U)	NFL四分卫俱乐部(美)
NFL Quarterback Club '96 (E)	NFL四分卫俱乐部96(欧)
NFL Quarterback Club '96 (J)	NFL四分卫俱乐部96(日)
NFL Quarterback Club '96 (U) (Beta)	NFL四分卫俱乐部96(美)(测试版)
NFL Quarterback Club '96 (U)	NFL四分卫俱乐部96(美)
NHL '94 (E)	NHL冰上曲棍球94(欧)
NHL '94 (U) (Beta)	NHL冰上曲棍球94(美)测试版
NHL '94 (U)	NHL冰上曲棍球94(美)
NHL '95 (E)	NHL冰上曲棍球95(欧)
NHL '95 (U)	NHL冰上曲棍球95(美)
NHL '96 (E)	NHL冰上曲棍球96(欧)
NHL '96 (U)	NHL冰上曲棍球96(美)
NHL '97 (E)	NHL冰上曲棍球97(欧)
NHL '97 (U) (Beta)	NHL冰上曲棍球97(美)(测试版)
NHL '97 (U)	NHL冰上曲棍球97(美)
NHL '98 (U)	NHL冰上曲棍球98(美)
NHL Pro Hockey '94 (J)	NHL专业冰上曲棍球(日)
NHL Stanley Cup (U) (M2)	NHL史丹利杯冰棍赛(美)(M2)
NHLPA Hockey '93 (E)	NHL PA冰棍赛93(欧)
NHLPA Hockey '93 (U)	NHL PA冰棍赛93(美)
Nice de Shot (J)	漂亮一杆(日)
Nichibutsu Arcade Classics (J)	怀旧大型电玩3合1(日)
Nichibutsu Arcade Classics 2 - Heiankyou Alien (J)	怀旧大型电玩2-平安京(日)
Nichibutsu Collection 1 (J)	纸园花+攻略赌城(日)
Nichibutsu Collection 2 (J)	超级五目将棋+麻雀繁盛记(日)
Nickelodeon Guts (U)	趣味运动竞技(美)
Nigel Mansell F-1 Challenge (J)	尼吉尔的F1挑战(日)
Nigel Mansell's World Championship Racing (E) (v1.0)	尼吉尔世界冠军赛车(欧) (v1.0)
Nigel Mansell's World Championship Racing (E) (v1.1)	尼吉尔世界冠军赛车(欧) (v1.1)
Nigel Mansell's World Championship Racing (U)	尼吉尔世界冠军赛车(美)
Ninja Gaiden Trilogy (U)	忍者龙剑传3合1(美)
Ninja Ryuukenden Tomoe (J)	忍者龙剑传3合1(日)
Ninjawarriors Again, The (J)	忍者战士-牙(日)
Ninjawarriors, The (E)	忍者战士-牙(欧)
Ninjawarriors, The (U)	忍者战士-牙(美)
Nintama Rantarou - Ninjutsu Gakuen Puzzle Taikai no Dan (J)
Nintama Rantarou (J)	忍者乱太郎1(日)
Nintama Rantarou 2 (J)	忍者乱太郎2(日)
Nintama Rantarou 3 (J)	忍者乱太郎3(日)
Nintama Rantarou Special (J)	忍者乱太郎特别版(日)
Nintendo Scope 6 (E)
Nishijin Pachinko 3 (J)
Nishijin Pachinko Monogatari (J)	西阵柏青哥物语1(日)
Nishijin Pachinko Monogatari 2 (J)	西阵柏青哥物语2(日)
Nitropunks - Might Heads (J)	阿飞的魔法头(日)
No Escape (U)	无路可退(美)
Nobunaga no Yabou - Haouden (J)	信长之野望-霸王传(日)
Nobunaga no Yabou - Tenshouki (J)	信长之野望-天翔记(日)
Nobunaga's Ambition - Lord of Darkness (U)
Nobunaga's Ambition (U)	信长之野望(美)
Nolan Ryan's Baseball (U)	诺?#123;雷恩的棒球(美)
Nomark Baku Haitou - Shijou Saikyou no Janshitachi (J)
Nontan to Issho - Kurukuru Puzzle (J)	克鲁克鲁方块(日)
Nosferatu (J)	古城救美(日)
Nosferatu (U)	古城救美(美)
Numbers Paradise (J)	猜数字大赛(日)
Obitus (U)	黑暗元素(美)
O-chan no Oekaki Logic (J)	逻辑绘图方块(日)
Oda Nobunaga - Haou no Gundan (J)
Odekake Lester - Lelele no Le (J)
Oekaki Logic (J) (NP)	逻辑绘图方块NP版(日)(NP)
Oekaki Logic 2 (J) (NP)	逻辑绘图方块NP版2(日)(NP)
Ogre Battle - The March of the Black Queen (U)	皇家骑士团(美)
Okamoto Ayako to Match Play Golf - Ko Olina Golf Club in Hawaii (J)	刚本绫子高尔夫(日)
Olivia's Mystery (J)	动感拼图(日)
Olympic Summer Games (E)	夏季奥运96(欧)
Olympic Summer Games (U)	夏季奥运96(美)
On the Ball (E)	360度转球(欧)
On the Ball (U)	360度转球(美)
Ongaku Tsukuru Kanaderu (J)	音乐編曲大师(日)
Onizuka Katsuya Super Virtual Boxing - Shin Kentou Ou Densetsu (J)	鬼塚胜也-真斗拳王传说(日)
Oomono Black Bass Fishing - Jinzouko Hen (J)
Oonita Atsushi FMW - Kagekara no Chousen (J)	日本异种格斗大赛(日)
Oozumou Damashii (J)	大相扑魂(日)
Operation Europe - Path to Victory 1939-45 (U)	欧洲军事作战(美)
Operation Logic Bomb (E)	怒之要塞(欧)
Operation Logic Bomb (U)	怒之要塞(美)
Operation Thunderbolt (U)	魔鬼任务(美)
Oraga Land Shusai - Best Farmar Shuukakusai (J)	三吉的收获祭(日)
Oscar (E)	小子欧西嘉(欧)
Oscar (U)	小子欧西嘉(美)
Ossu!! Karate-bu (J)	押忍空手部(日)
Othello World (J)	黑白棋(日)
Otoboke Ninja Colosseum (J)	轰炸忍者超人(日)
Otogirisou (J)	第切草(日)
Out of This World (U) (Beta)	逃离异世界(美)测试版
Out of This World (U)	逃离异世界(美)
Out to Lunch (E)	逃跑的午餐(欧)
Out to Lunch (U)	逃跑的午餐(美)
Outer World (J)	逃离异世界-日
Outlander (E)	国外跑车赛(欧)
Outlander (U)	国外跑车赛(美)
Pac-Attack (E)	小精灵方块(欧)
Pac-Attack (U)	小精灵方块(美)
Pachinko Challenger (J)	柏青哥挑战者(日)
Pachinko Fan - Shouri Sengen (J)
Pachinko Maruhi Hisshouhou (J)
Pachinko Monogatari - Pachi-Slot mo Aru deyo!! (J)	柏青哥物语(日)
Pachinko Monogatari 2 - Nagoya Shachihoko no Teiou (J)	柏青哥物语2(日)
Pachinko Ren-chan Tengoku - Super CR Special (J)	柏青哥-连莊天国(日)
Pachinko Tetsujin - Nanaban Shoubu (J)	柏青哥铁人-七番胜負(日)
Pachinko Wars (J)	柏青哥大战(日)
Pachinko Wars II (J)	柏青哥大战2(日)
Pachio-kun Special (J)	柏青哥君-特别版(日)
Pachio-kun Special 2 (J)	柏青哥君-特别版2(日)
Pachio-kun Special 3 (J)	柏青哥君-特别版3(日)
Pachi-Slot Gambler (J)
Pachi-Slot Kanzen Kouryaku - Universal Shindai Nyuuka Volume 1 (J)
Pachi-Slot Kenkyuu (J)	水果盘研究(日)
Pachi-Slot Land - Pachipachi Coin no Densetsu (J)	水果盘岛(日)
Pachi-Slot Love Story (J)	水果盘-爱的故事(日)
Pachi-Slot Monogatari - PAL Kougyou Special (J)	水果盘物语(日)
Pachi-Slot Monogatari - Universal Special (J)	水果盘物语-通用版(日)
Pacific Theater of Operations (U)	提督的决断(美)(与政治无关)
Pacific Theater of Operations II (U)	提督的决断2(美)(与政治无关)
Pac-in-Time (E) (Beta)
Pac-in-Time (E)
Pac-in-Time (J)
Pac-in-Time (U)
Packy & Marlon (U) (M3)	大象乐园(美)
Pac-Man 2 - The New Adventures (F)
Pac-Man 2 - The New Adventures (G)
Pac-Man 2 - The New Adventures (U)
Pagemaster, The (E)	魔法大圣(欧)
Pagemaster, The (U) (Beta)	魔法大圣(美)(测试版)
Pagemaster, The (U)	魔法大圣(美)
Paladin's Quest (U)	魔星迷踪(美)
Panel de Pon (J)	花仙子方块(日)
Panic in Nakayoshi World (J)	美少女抢救大作战(日)
Paperboy 2 (E)	送报童2(欧)
Paperboy 2 (U)	送报童2(美)
Parlor! Mini - Pachinko Jikki Simulation Game (J)	迷你柏青哥实机测试1(日)
Parlor! Mini 2 - Pachinko Jikki Simulation Game (J)	迷你柏青哥实机测试2(日)
Parlor! Mini 3 - Pachinko Jikki Simulation Game (J)	迷你柏青哥实机测试3(日)
Parlor! Mini 4 - Pachinko Jikki Simulation Game (J)	迷你柏青哥实机测试4(日)
Parlor! Mini 5 - Pachinko Jikki Simulation Game (J)	迷你柏青哥实机测试5(日)
Parlor! Mini 6 - Pachinko Jikki Simulation Game (J)	迷你柏青哥实机测试6(日)
Parlor! Mini 7 - Pachinko Jikki Simulation Game (J)	迷你柏青哥实机测试7(日)
Parlor! Parlor! (J)
Parlor! Parlor! 2 (J)
Parlor! Parlor! 3 (J)
Parlor! Parlor! 5 (J)
Parlor! Parlor! IV CR (J)
Parodius - Non-Sense Fantasy (E)	疯狂大射击(欧)
Parodius da! - Shinwa Kara Owarai he (J)	疯狂大射击(日)
Peace Keepers, The (U)	快打刑事-和平守护者(美)
Pebble Beach Golf Links (E)	圆石海岸高尔夫赛(欧)
Pebble Beach Golf Links (U)	圆石海岸高尔夫赛(美)
Pebble Beach no Hatou (J)	海岸高尔夫球(日)
Pebble Beach no Hatou New - Tournament Edition (J)	海岸高尔夫球2(日)
PGA European Tour (E)	PGA高尔夫欧洲公开赛(欧)
PGA European Tour (U)	PGA高尔夫欧洲公开赛(美)
PGA Tour '96 (E)	PGA高尔夫公开赛96(欧)
PGA Tour '96 (U)	PGA高尔夫公开赛96(美)
PGA Tour Golf (E)	PGA高尔夫公开赛(欧)
PGA Tour Golf (J)	PGA高尔夫公开赛(日)
PGA Tour Golf (U)	PGA高尔夫公开赛(美)
Phalanx - The Enforce Fighter A-144 (E)	激空战机(欧)
Phalanx - The Enforce Fighter A-144 (J)	激空战机(日)
Phalanx - The Enforce Fighter A-144 (U) (Beta)	激空战机(美)(测试版)
Phalanx - The Enforce Fighter A-144 (U)	激空战机(美)
Phantom 2040 (E) (M3)	幽魂2040(欧)(M3)
Phantom 2040 (U) (Beta)	幽魂2040(美)测试版
Phantom 2040 (U)	幽魂2040(美)
Picross NP Vol. 1 (J) (NP)	任天堂逻辑绘图1(日) (NP)
Picross NP Vol. 2 (J) (v1.0) (NP)	任天堂逻辑绘图2(日)1.0(NP)
Picross NP Vol. 2 (J) (v1.1) (NP)	任天堂逻辑绘图2(日)1.1(NP)
Picross NP Vol. 3 (J) (NP)	任天堂逻辑绘图3(日)(NP)
Picross NP Vol. 4 (J) (NP)	任天堂逻辑绘图4(日)(NP)
Picross NP Vol. 5 (J) (NP)	任天堂逻辑绘图5(日)(NP)
Picross NP Vol. 6 (J) (NP)	任天堂逻辑绘图6(日)(NP)
Picross NP Vol. 7 (J) (NP)	任天堂逻辑绘图7(日)(NP)
Picross NP Vol. 8 (J) (NP)	任天堂逻辑绘图8(日)(NP)
Pieces (U)	对战拼图(美)
Pikiinya! (J)	企鹅方块(日)
Pilotwings (E)	飞行俱乐部(欧)
Pilotwings (J)	飞行俱乐部(日)
Pilotwings (U)	飞行俱乐部(美)
Pinball Dreams (E) (Beta)	梦幻弹珠台(欧)测试板
Pinball Dreams (E)	梦幻弹珠台(欧)
Pinball Dreams (U)	梦幻弹珠台(美)
Pinball Fantasies (E)	幻想弹珠台(欧)
Pinball Fantasies (U)	幻想弹珠台(美)
Pinball Pinball (J)	弹珠台(日)
Pink Panther in Pink Goes to Hollywood (E)	顽皮豹好莱坞冒险(欧)
Pink Panther in Pink Goes to Hollywood (J)	顽皮豹好莱坞冒险(日)
Pink Panther in Pink Goes to Hollywood (U)	顽皮豹好莱坞冒险(美)
Pinocchio (E)	木偶奇遇记(欧)
Pinocchio (J)	木偶奇遇记(日)
Pinocchio (U)	木偶奇遇记(美)
Pipe Dream (J)	水管狂想记(日)
Pirates of Dark Water, The (E)	黑暗之水(欧)
Pirates of Dark Water, The (U)	黑暗之水(美)
Pitfall - Maya no Daibouken (J)	玛亚冒险(日)
Pitfall - The Mayan Adventure (E)	玛亚冒险(欧)
Pitfall - The Mayan Adventure (U) (Beta)	玛亚冒险(美)测试版
Pitfall - The Mayan Adventure (U)	玛亚冒险(美)
Pit-Fighter (E)	街头地下格斗(欧)
Pit-Fighter (U)	街头地下格斗(美)
Planet's Champ TG 3000, The (J)	行星杯赛车3000(日)
Plok! (E)	普罗克大冒险(欧)
Plok! (G)	普罗克大冒险(德)
Plok! (J)	普罗克大冒险(日)
Plok! (U)	普罗克大冒险(美)
P-Man (J)	口袋怪物-小智图示(日)
Pocky & Rocky (E) (Sample)	奇奇怪界(欧)(Sample)
Pocky & Rocky (E)	奇奇怪界(欧)
Pocky & Rocky (U)	奇奇怪界(美)
Pocky & Rocky 2 (E)	奇奇怪界2(欧)
Pocky & Rocky 2 (U) [186E]	奇奇怪界2(美)[186E]
Pocky & Rocky 2 (U) [D3EA]	奇奇怪界2(美)[D3EA]
Poko Nyan! - Henpokorin Adventure (J)	叮当猫(日)
Popeye - Ijiwaru Majo Sea Hag no Maki (J)	大力水手(日)
Popful Mail (J)
Pop'n TwinBee - Rainbow Bell Adventures (E)	兵蜂-彩虹铃当的冒险(欧)
Pop'n TwinBee - Rainbow Bell Adventures (G)	兵蜂-彩虹铃当的冒险(德)
Pop'n TwinBee (E)	兵蜂(欧)
Pop'n TwinBee (J)	兵蜂(日)
Popoitto Hebereke (J)	魔法气泡奇特版(日)
Populous (E)	诸神世纪(欧)
Populous (J)	诸神世纪(日)
Populous (U)	诸神世纪(美)
Populous II - Trials of the Olympian Gods (E)	诸神世纪2(欧)
Populous II - Trials of the Olympian Gods (G)	诸神世纪2(德)
Populous II - Trials of the Olympian Gods (J)	诸神世纪2(日)
Porky Pig's Haunted Holiday (E)	猪小弟的万圣节冒险(欧)
Porky Pig's Haunted Holiday (U) [151B]	猪小弟的万圣节冒险(美)[151B]
Porky Pig's Haunted Holiday (U) [3B29]	猪小弟的万圣节冒险(美)[3B29]
Power Athlete (J)	超能战士(日)
Power Drive (E) (M5)	威力赛车(欧) (M5)
Power Instinct (U) (Beta)	豪血寺一族(美)(测试版)
Power Instinct (U)	豪血寺一族(美)
Power Lode Runner (J) (NP)	掏金者加强版(日)(NP)
Power Moves (U)	超能战士(美)
Power of the Hired (J)	魔兽使传说(日)
Power Piggs of the Dark Age (E) (Beta)	猪战士(欧)(测试版)
Power Piggs of the Dark Age (E)	猪战士(欧)
Power Piggs of the Dark Age (U)	猪战士(美)
Power Rangers Zeo - Battle Racers (U)	金刚战士赛车(美)
Power Soukoban (J)	仓库番加强版(日)
PowerMonger - Mashou no Bouryaku (J)	动力贩卖-(日)
PowerMonger (E)	动力贩卖-(欧)
Prehistorik Man (E) (M3)	原始人大进击(欧)(M3)
Prehistorik Man (U)	原始人大进击(美)
Primal Rage (E)	恐龙格斗(欧)
Primal Rage (U) (With Sound Test)	恐龙格斗(美)(有声测试版)
Primal Rage (U)	恐龙格斗(美)
Prime (U) (Beta)	雷霆超人(美)(测试版)
Prince of Persia (E)	波斯王子(欧)
Prince of Persia (J)	波斯王子(日)
Prince of Persia (U)	波斯王子(美)
Prince of Persia 2 - The Shadow & The Flame (E)	波斯王子2(欧)
Prince of Persia 2 - The Shadow & The Flame (U)	波斯王子2(美)
Princess Maker - Legend of Another World (J)	美少女梦工厂(日)
Princess Minerva (J)	智王传说(日)
Pro Football (J)	专业美式足球(日)
Pro Football '93 (J)	专业美式足球93(日)
Pro Kishi Jinsei Simulation - Shougi no Hanamichi (J)	将棋之花道(日)
Pro Mahjong Kiwame (J)	极麻雀(日)
Pro Mahjong Kiwame II (J) (v1.0)	极麻雀2(日)1.0
Pro Mahjong Kiwame II (J) (v1.1)	极麻雀2(日)1.1
Pro Mahjong Kiwame III (J)	极麻雀3(日)
Pro Mahjong Tsuwamono - Renka Ban (J)	麻雀兵法1.0(日)
Pro Mahjong Tsuwamono (J)	麻雀兵法1.1(日)
Pro Quarterback (U)	专业四分卫(美)
Pro Soccer (J)	专业足球(日)
Pro Sport Hockey (U)	专业冰上曲棍球(美)
Pro Yakyuu Nettou Puzzle Stadium (J) (Beta)	热斗野球方块(日)测试版
Pro Yakyuu Nettou Puzzle Stadium (J)	热斗野球方块(日)
Pro Yakyuu Star (J)	野球之星(日)
Psycho Dream (J)	虚幻之梦(日)
Push-Over (E) (M4)	益智推骨牌(欧)(M4)
Push-Over (U) (Beta)	益智推骨牌(美)测试版
Push-Over (U)	益智推骨牌(美)
Putty Moon (J)	点点君(日)
Putty Squad (E)	点点君大进击(欧)
Puzzle Bobble - Bust-A-Move (E)	泡泡龙(欧)
Puzzle Bobble (J)	泡泡龙(日)
Puzzle'n Desu! (J)	欢乐推方块(日)
1Q-bert 3 (J)	立体跳方块3(日)
2Q-bert 3 (U)	立体跳方块3(美)
Race Drivin' (E)	立体跑车大赛(欧)
Race Drivin' (U)	立体跑车大赛(美)
Radical Psycho Machine Racing (J)
Radical Psycho Machine Racing (U)
Radical Rex (E)	雷克斯龙冒险(欧)
Radical Rex (U) (Beta)	雷克斯龙冒险(美)
Radical Rex (U)	雷克斯龙冒险(美)
Raiden Densetsu (J)	雷电传说(日)
Raiden Trad (U)	雷电传说(美)
Ramos Rui no World Wide Soccer (J)	拉蒙斯的世界足球(日)
Rampart (U)	堡垒守卫战(美)
Ranma 1-2 - Akanekodan Teki Hihou (J)	乱马1/2-朱猫团的秘宝(日)
Ranma 1-2 - Bakuretsu Rantou Hen (J)	乱马1/2爆裂乱斗篇(日)
Ranma 1-2 - Chougi Ranbu Hen (J)	乱马1/2超技乱舞篇(日)
Ranma 1-2 - Chounai Gekitou Hen (J)	乱马1/2村內激斗篇(日)
Ranma 1-2 - Hard Battle (U)	乱马1/2爆裂乱斗篇(美)
Ranma 1-2 - Ougi Jaanken (J)	乱马1/2奥义邪暗拳(日)
Ranma 1-2 (E)	乱马1/2爆裂乱斗篇(欧)
Ranma 1-2 (F)	乱马1/2爆裂乱斗篇(法)
Rap Basketball (U) (Beta)
Rap Jam - Volume One (U) (M3)	篮球一对一(美)(M3)
Realm (E)	雷霆英豪(欧)
Realm (U)	雷霆英豪(美)
Redline F-1 Racer (U)	F1赛车-红线的那一端(美)
Rejoice - Aretha Oukoku no Kanata (J)	阿蕾莎外传(日)
Relief Pitcher (U) (Beta)	投打大赛(美)(测试版)
Relief Pitcher (U)	投打大赛(美)
Ren & Stimpy Show, The - Buckeroos! (U)	雷恩与史地皮-牛仔(美)
Ren & Stimpy Show, The - Fire Dog (U)	雷恩与史地皮-消防犬 (美)
Ren & Stimpy Show, The - Time Warp (E)	雷恩与史地皮-扭曲时间(欧)
Ren & Stimpy Show, The - Time Warp (U)	雷恩与史地皮-扭曲时间(美)
Ren & Stimpy Show, The - Veediots! (E)	雷恩与史地皮-疯狂家庭(欧)
Ren & Stimpy Show, The - Veediots! (U)	雷恩与史地皮-疯狂家庭(美)
Rendering Ranger R2 (J)	未来骑警 R2(日)
Res Arcana - Diana Rei - Uranai no Meikyuu (J)	占卜迷宫(日)
Return of Double Dragon (J)
Revolution X (E)	X革命(欧
Revolution X (G)	X革命(德)
Revolution X (J)	X革命(日)
Revolution X (U)	X革命(美)
Rex Ronan - Experimental Surgeon (U)	联合缩小军(美)
RHI Roller Hockey '95 (U) (Beta)	RHI冰上曲棍球95(美)-(测试版)
Riddick Bowe Boxing (J)	瑞迪克拳击(日)
Riddick Bowe Boxing (U)	瑞迪克拳击(美)
Rin Kaihou Kudan no Igo Taidou (J)	定基大道(日)
Ring ni Kakero (J) (NP)	热斗神拳 (NP)
Rise of the Phoenix (U)	升凤传(美)
Rise of the Robots (E)	升刚机器人(欧)
Rise of the Robots (J)	升刚机器人(日)
Rise of the Robots (U) (Beta)	升刚机器人(美)测试版
Rise of the Robots (U)	升刚机器人(美)
Rival Turf (E)	快打刑事(欧)
Rival Turf (U)	快打刑事(美)
Riverse Kids (J) (Unl)	流转小子(日)(Unl)
Road Riot 4WD (E)	4轮越野赛车(欧)
Road Riot 4WD (U) [0F0A]	4轮越野赛车(美)[0F0A]
Road Riot 4WD (U) [18D9]	4轮越野赛车(美)[18D9]
Road Runner (E) (Beta)	BB鸟与大野狼(欧)(测试版)
Road Runner (E)	BB鸟与大野狼(欧)
Road Runner's Death Valley Rally (U)	BB鸟与大野狼(美)
RoboCop 3 (E)	机器战警3(欧)
RoboCop 3 (U) (NSS)	机器战警3(美)(NSS)
RoboCop 3 (U)	机器战警3(美)
RoboCop versus the Terminator (E)	机器战警VS终结者(欧)
RoboCop versus the Terminator (U)	机器战警VS终结者(美)
Robotrek (U)	勇者机器人(美)
Rock n' Roll Racing (E)	摇滚赛车(欧)
Rock n' Roll Racing (J)	摇滚赛车(日)
Rock n' Roll Racing (U) (Beta)	摇滚赛车(美)(测试版)
Rock n' Roll Racing (U)	摇滚赛车(美)
Rocketeer, The (J)
Rocketeer, The (U)
Rockman & Forte (J)	洛克人与佛鲁迪(日)
Rockman 7 - Shukumei no Taiketsu! (J)	洛克人7(日)
Rockman X (J) (v1.0)	洛克人X1.0(日)
Rockman X (J) (v1.1)	洛克人X1.1(日)
Rockman X2 (J)	洛克人X2(日)
Rockman X3 (J)	洛克人X3(日)
Rockman's Soccer (J)	洛克人足球(日)
Rocko's Modern Life - Spunky's Dangerous Day (U)	洛可的摩登生活(美)
Rocky Rodent (E)	阿飞的魔法头(欧)
Rocky Rodent (U)	阿飞的魔法头(美)
Roger Clemens' MVP Baseball (J)	罗格的MVP棒球(日)
Roger Clemens' MVP Baseball (U) [A00A]	罗格的MVP棒球(美)[A00A]
Roger Clemens' MVP Baseball (U) [A5C9]	罗格的MVP棒球(美)[A5C9]
Rokudenashi Blues - Taiketsu! Tokyo Shitennou (J)
Romance of the Three Kingdoms II (U)	三国志2(美)
Romance of the Three Kingdoms III - Dragon of Destiny (U)	三国志3(美)
Romance of the Three Kingdoms IV - Wall of Fire (U)	三国志4(美)
Romancing Sa-Ga (J) (v1.0)	复活邪神1-1.0(日)
Romancing Sa-Ga (J) (v1.1)	复活邪神1-1.1(日)
Romancing Sa-Ga 2 (J)	复活邪神2(日)
Romancing Sa-Ga 3 (J) (Sample)	复活邪神3-(日)体验版
Romancing Sa-Ga 3 (J) (v1.0)	复活邪神3-1.0(日)
Romancing Sa-Ga 3 (J) (v1.1)	复活邪神3-1.1(日)
Royal Conquest (J)	皇家战士(日)
RPG Tsukuru - Super Dante (J)	RPG工具(日)
RPG Tsukuru 2 (J)	RPG工具2(日)
R-Type III - The Third Lightning (E) [164F]
R-Type III - The Third Lightning (E) [53CB]
R-Type III - The Third Lightning (J)
R-Type III - The Third Lightning (U)
Rudra no Hihou (J)	魔诫圣战/鲁多拉秘宝(日)
Ruin Arm (J)	毁灭武器(日)
Run Saber (E)	天龙斩(欧)
Run Saber (U)	天龙斩(美)
Rushing Beat (J)	快打刑事(日)
Rushing Beat Ran - Fukusei Toshi (J)	快打刑事-乱(日)
Rushing Beat Shura (J)	快打刑事-修罗(日)
Ryuuki Heidan Danzalv (J)
Ryuuko no Ken (J)	龙虎之拳(日)
Ryuuko no Ken 2 (J)	龙虎之拳2(日)
Saibara Rieko no Mahjong Hourouki (J)	雀皇战 (日)
Saikousoku Shikou - Shougi Mahjong (J)
Saikyou - Takada Nobuhiko (J)	高田延彥-最强摔角 (日)
Sailormoon (F)	美少女战士 (F)
Sakurai Shouichi no Jankiryuu - Mahjong Hisshouhou (J)
Same Game (J)
Samurai Shodown (E)	侍魂(欧)
Samurai Shodown (U)	侍魂(美)
Samurai Spirits (J) (Beta)	侍魂-测试版 (日)
Samurai Spirits (J)	侍魂-测试版 (日)
Sandro no Daibouken - Valkyrie Tono Deai (J)
Sangokushi Eiketsuden (J)
Sangokushi III (HK)	三国志3 (港)
Sangokushi III (J) (v1.0)	三国志3 (日)
Sangokushi III (J) (v1.1)	三国志3 (日)
Sangokushi IV (J)	三国志4 (日)
Sangokushi Seishi - Tenbu Spirits (J)	天舞三国志(日)
Sankyo Fever! Fever! (J)	柏青哥狂热 (日)
Sanrio Shanghai (J)	三利欧-上海 (日)
Sanrio World Smash Ball! (J)	三利欧世界-爆裂斗球
Sansara Naga 2 (J)	育龙战记2 (日)
Satellaview BS-X BIOS (J)	卫星通讯系统 (日)
Saturday Night Slam Masters (E)	霸王摔角 (欧)
Saturday Night Slam Masters (U)	霸王摔角 (美)
Scooby-Doo Mystery (U)	鬼屋特攻队 (美)
SD F-1 Grand Prix (J)	F1GP赛车 (日)
SD Gundam - Power Formation Puzzle (J)	SD刚弹方块
SD Gundam Gaiden - Knight Gundam Monogatari - Ooinaru Isan (J) (v1.0)	SD高达外传 (1.0版) (日)
SD Gundam Gaiden - Knight Gundam Monogatari - Ooinaru Isan (J) (v1.1)	SD高达外传 (1.1版) (日)
SD Gundam Gaiden 2 - Entaku no Kishi (J)	SD高达外传2 (日)
SD Hiryuu no Ken (J)
SD Kidou Senshi Gundam - V Sakusen Shidou (J)	SD机动战记 (日)
SD Kidou Senshi Gundam 2 (J)	SD机动战记2 (日)
SD The Great Battle - Aratanaru Chousen (J)	SD英雄大战 (日)
SeaQuest DSV (E)	深海潜舰 (欧)
SeaQuest DSV (U)	深海潜舰 (美)
Secret of Evermore (E)	永远的神秘 (英)
Secret of Evermore (F)	永远的神秘 (F)
Secret of Evermore (G)	永远的神秘 (德)
Secret of Evermore (S)	永远的神秘 (S)
Secret of Evermore (U)	永远的神秘 (美)
Secret of Mana (E) (v1.0)	圣剑传说 (欧) (1.0版)
Secret of Mana (E) (v1.1)	圣剑传说 (欧) (1.1版)
Secret of Mana (F)	圣剑传说 (F)
Secret of Mana (G)	圣剑传说 (德)
Secret of Mana (U)	圣剑传说 (美)
Seifuku Densetsu Pretty Fighter (J)	制服传说 (日)
Seijuu Maden Beasts & Blades (J)	圣兽魔传 (日) ?
Seiken Densetsu 2 (J)	圣剑传说2 (日)
Seiken Densetsu 3 (J) (Sample)	圣剑传说3 (日)
Seiken Densetsu 3 (J)	圣剑传说3 (日)
Sengoku Denshou (J)	战国传承 (日)
Sengoku no Hasha - Tenkafubu heno Michi (J)
Sensible Soccer - International Edition (E) (M4) (v1.1)	感觉足球-国际版 (欧)
Sensible Soccer (E) (M4) [7922]	感觉足球 (欧)
Sensible Soccer (E) (M4) [91F2]	感觉足球 (欧)
Septentrion (J)	沉船危机 (日)
Serizawa Nobuo no Birdie Try (J)	芹泽信雄的高尔夫 (日)
Sgt. Saunders' Combat! (J)	勇者无懼 (日)
Shadow, The (U) (Beta) [50A3]	魅影-测试版 (美)
Shadow, The (U) (Beta) [97E7]	魅影-测试版 (美)
Shadowrun (E)	死而复生 (欧)
Shadowrun (G)	死而复生 (德)
Shadowrun (J)	死而复生 (日)
Shadowrun (SW)	死而复生 (SW)
Shadowrun (U) (Beta)	死而复生 测试版 (美)
Shadowrun (U)	死而复生 (美)
Shanghai - Banri no Choujou (J)	上海之万里长城 (日)
Shanghai II - Dragon's Eye (U)	上海2 (美)
Shanghai III (J)	上海3 (日)
Shaq Fu (E)	单福 (欧)
Shaq Fu (U) (Beta)	单福 测试版 (美)
Shaq Fu (U)	单福 (美)
Shichuusui Meigaku Nyuumon - Shin Tougenkyou (J)
Shien - The Blade Chaser (J)	紫炎 (日)
Shien's Revenge (U) (Beta)	紫炎 测试版 (美)
Shien's Revenge (U)	紫炎 (美)
Shijou Saikyou League Serie A - Ace Striker (J)	史上最强足球王 (日)
Shijou Saikyou no Quiz Ou Ketteisen Super (J)	史上最强问答王决定战 (日)
Shiki Eiyuuden - Jinryuu Densetsu (J)
Shimono Masaki no Fishing to Bassing (J)	巴斯钓鱼大会赛 (日)
Shin Chou Kouki (J)	信长公记 (日)
Shin Ikkakusenkin (J)
Shin Kidou Senki Gundam W - Endless Duel (J)	新机动战记-高达W (日)
Shin Mahjong (J)
Shin Megami Tensei (J) (v1.0)	魔神转生 1.0版 (日)
Shin Megami Tensei (J) (v1.1)	魔神转生 1.1版 (日)
Shin Megami Tensei if... (J)	魔神转生 (日)
Shin Megami Tensei II (J)	魔神转生2 (日)
Shin Momotarou Densetsu (J)	新桃太郎传说 (日)
Shin Naki no Ryuu - Mahjong Hishouden (J)	哭泣之龙 (日)
Shin Nekketsu Kouha - Kunio-tachi no Banka (J)	热血硬派-国雄之挽歌 (日)
Shin Nihon Pro Wresling - Chou Senshi in Tokyo Dome - Fantastic Story (J)	超战士IN斗强导梦 (日)
Shin Nihon Pro Wresling Kounin - '94 Battlefield in Tokyo Dome (J)	94摔角战场in斗强导梦 (日)
Shin Nihon Pro Wresling Kounin - '95 Tokyo Dome Battle 7 (J)	95斗强导梦 (日)
Shin SD Sengokuden - Daishougun Retsuden (J)	新SD战国传-大将军列传 (日)
Shin Shougi Club (J)
Shin Star Trek - The Next Generation - Ooinaru Isan IFD no Nazo no Oe (J)	星舰迷航记 (日)
Shinri Game 2, The - Magical Trip (J)	心理游戏2 (日)
Shinri Game 3, The (J)	心理游戏3 (日)
Shinri Game, The - Akuma no Kokoroji (J)	心理游戏 (日)
Shinseiki GPX Cyber Formula (J)	闪电霹雳车 (日)
Shinseiki Odysselya (J)	神圣记 (日)
Shinseiki Odysselya II (J)	神圣记2 (日)
Shinzui Taikyoku Igo - Go Sennin (J)	基仙人 (日)
Shiroi Ring he Twinkle Little Star (J)	女子摔角-闪耀之星传说 (日)
Shodai Nekketsu Kouha Kunio-kun (J)	初代热血硬派 (日)
Shodan Morita Shougi (J)	初段森田将棋 (日)
Shodani Nintei - Shodan Pro Mahjong (J)	初段麻将段位认定 (日)
Shougi Club (J)	将棋俱乐部 (日)
Shougi Fuurin Kazan (J)	风林火山 (日)
Shougi Saikyou (J)
Shougi Saikyou II - Jissen Taikyoku Hen (J)
Shougi Zanmai (J)	将棋三昧 (日)
Shounen Ashibe - Goma-chan no Yuuenchi Daibouken (J)	少年亚奇贝 (日)
Shounen Ninja Sasuke (J)	忍者小子 (日)
Shounin yo, Taishi wo Idake!! (J)	商人立志传 (日)
Shuushoku Game (J)
Side Pocket (E)	撞球入袋 (欧)
Side Pocket (J)	撞球入袋 (日)
Side Pocket (U)	撞球入袋 (美)
Silva Saga II - The Legend of Light and Darkness (J)	魔界佣兵2 (日)
Sim Ant (J)	模拟蚂蚁 (日)
Sim Ant (U) [90F9]	模拟蚂蚁 (美)[90F9]
Sim Ant (U) [BF96]	模拟蚂蚁 (美)[BF96]
Sim City (E)	模拟城市 (欧)
Sim City (F)	模拟城市 (法)
Sim City (G)	模拟城市 (德)
Sim City (J)	模拟城市 (日)
Sim City (U)	模拟城市 (美)
Sim City 2000 (E)	模拟城市2000 (欧)
Sim City 2000 (J)	模拟城市2000 (日)
Sim City 2000 (U)	模拟城市2000 (美)
Sim City Jr. (J)	模拟城市2 (日)
Sim Earth - The Living Planet (J)	模拟地球 (日)
Sim Earth - The Living Planet (U)	模拟地球 (美)
Simpsons, The - Bart no Fushigi na Yume no Daibouken (J)	辛普森家庭-霸子的恶梦 (日)
Simpsons, The - Bart's Nightmare (E)	辛普森家庭-霸子的恶梦 (欧)
Simpsons, The - Bart's Nightmare (U)	辛普森家庭-霸子的恶梦 (美)
Simulation Pro Yakyuu (J)
Sink or Swim (E)	浮与沉 (欧)
Sink or Swim (U)	浮与沉 (美)
Ski Paradise with Snowboard (J)	滑雪天堂 (日)
Skuljagger - Revolt of the Westicans (U) (Beta)
Skuljagger - Revolt of the Westicans (U)
Sky Mission (J)	天空任务 (日)
Skyblazer (E)	迦楼逻王 (欧)
Skyblazer (U) (Beta)	迦楼逻王 (美)
Skyblazer (U)	迦楼逻王 (美)
Slap Stick (J)	勇者机器人 (日)
Slayers (J)	秀斗魔导士-圣龙传说 (日)
Smart Ball (U)	史莱姆大进击 (美)
Smash T.V. (J)	电视斗士 (日)
Smash Tennis (E) (Beta)	网球大会 (欧)
Smash Tennis (E)	网球大会 (欧)
Smurfs 2, The (E) (M4)	色小精灵2 (欧)
Smurfs, The (E) (M5)	色小精灵 (欧)
Snoopy Concert (J)	史奴比音乐会 (日)
Snow White in Happily Ever After (U)	幸福永在雪白后 (美)
Soccer Kid (E) (M5)	足球小子 (欧)
Soccer Kid (J) (Beta)	足球小子 (日)(测试版)
Soccer Kid (J)	足球小子 (日)
Soccer Shootout (E)	足球暴射入网 (欧)
Soldiers of Fortune (U)	未来佣兵 (美)
Solid Runner (J)	暗龙传说 (日)
Solstice II (J)	秘境魔宝2 (日)
Song Master (J)	音乐大师 (日)
Sonic Blast Man (E)	音速快击手 (欧)
Sonic Blast Man (J)	音速快击手 (日)
Sonic Blast Man (U)	音速快击手 (美)
Sonic Blast Man II (J)	音速快击手2 (日)
Sonic Blast Man II (U)	音速快击手2 (美)
Sonic Wings (J)	铁鹰战士 (日)
Soreyuke Ebisumaru Karakuri Meiro - Kieta Goemon no Nazo!! (J)	大盗伍佑卫门迷路记 (日)
SOS (U)	潜舰攻击 (美)
Sotsugyou Bangai Hen - Nee Mahjong Shiyo! (J)	卒业麻雀 (日)
Sougou Kakutougi Astral Bout (J)
Sougou Kakutougi Astral Bout 2 - The Total Fighters (J)
Sougou Kakutougi Rings - Astral Bout 3 (J)
Soukou Kihei Votoms - The Battling Road (J)
Soul & Sword (J)	灵魂与剑 (日)
Soul Blader (J)	创世封魔录 (日)
Soul Blazer (E)	创世封魔录 (欧)
Soul Blazer (F)	创世封魔录 (法)
Soul Blazer (G)	创世封魔录 (德)
Soul Blazer (U)	创世封魔录 (美)
Sound Novel Tsukuru (J)	音乐制造者 (日)
Space Ace (E)	太空高手 (欧)
Space Ace (J)	太空高手 (日)
Space Ace (U) (Beta)	太空高手 (美)
Space Ace (U)	太空高手 (美)
Space Bazooka (J)	太空火箭炮 (日)
Space Football - One on One (U)	太空足球 (美)
Space Funky B.O.B. (J)	蚂蚁战士 (日)
Space Invaders - The Original Game (E)	太空入侵者 (欧)
Space Invaders - The Original Game (J)	太空入侵者 (日)
Space Invaders - The Original Game (U)	太空入侵者 (美)
Space Megaforce (U)	太空争霸 (美)
Spanky's Quest (E)	猴子大冒险 (欧)
Spanky's Quest (U)	猴子大冒险 (美)
Spark World (J)	轰炸汽车 (日)
Sparkster (E)	火箭骑士 (欧)
Sparkster (J)	火箭骑士 (日)
Sparkster (U)	火箭骑士 (美)
Spawn (E)	闪灵悍将 (欧)
Spawn (J) (Beta)	闪灵悍将 测试版 (日)
Spawn (U)	闪灵悍将 (美)
Spectre (E)	幽灵大射击 (欧)
Spectre (U)	幽灵大射击 (美)
Speed Racer (U)	竞速天龙 (美)
Speedy Gonzales in Los Gatos Bandidos (E) (Beta)	飞毛腿 测试版 (欧)
Speedy Gonzales in Los Gatos Bandidos (U) (Beta)	飞毛腿 测试版 (美)
Speedy Gonzales in Los Gatos Bandidos (U) (v1.0)	飞毛腿 1.0版 (美)
Speedy Gonzales in Los Gatos Bandidos (U) (v1.1)	飞毛腿 1.1版 (美)
SpellCraft (U) (Beta)	咒术世界 测试版 (美)
Spider-Man & Venom - Maximum Carnage (E)	蜘蛛人-大屠杀 (欧)
Spider-Man & Venom - Maximum Carnage (U)	蜘蛛人-大屠杀 (美)
Spider-Man & Venom - Separation Anxiety (E)	蜘蛛人-解除欲望 (欧)
Spider-Man & Venom - Separation Anxiety (U)	蜘蛛人-解除欲望 (美)
Spider-Man (E)	蜘蛛人-原点 (欧)
Spider-Man (U) (Beta)	蜘蛛人-原点 测试版 (美)
Spider-Man (U)	蜘蛛人-原点 (美)
Spider-Man and the X-Men in Arcade's Revenge (E)	蜘蛛人与特异功能组 (欧)
Spider-Man and the X-Men in Arcade's Revenge (U) (4 Man Version)	蜘蛛人与特异功能组-4人版 (美)
Spider-Man and the X-Men in Arcade's Revenge (U)	蜘蛛人与特异功能组 (美)
Spindizzy Worlds (E)	宇宙陀螺仪 (欧)
Spindizzy Worlds (U)	宇宙陀螺仪 (美)
Spirou (E) (M4)	宇宙陀螺仪 (欧)
Sporting News Power Baseball, The (U)	运动新闻棒球 (美)
Sports Illustrated Championship Football & Baseball (U) (Beta)	冠军足球&棒球 (美)
Sports Illustrated Championship Football & Baseball (U) [781D]	冠军足球&棒球 (美)
Sports Illustrated Championship Football & Baseball (U) [9952]	冠军足球&棒球 (美)
Spriggan Powered (J)	雷霆机器人 (日)
Sprinter Monogatari - Mezase!! Ikkakusenkin (J)	自行车物语 (日)
St. Andrews - Eikou to Rekishi no Old Course (J)	安德鲁的荣光高尔夫 (日)
Stable Star - Kyuusha Monogatari (J)
Star Fox - Super Weekend Competition (U)	星战火狐-比赛版 (美)
Star Fox (J)	星战火狐 (日)
Star Fox (U) (v1.0)	星战火狐 1.0版 (美)
Star Fox (U) (v1.2)	星战火狐 1.2版 (美)
Star Fox 2 (J) (Beta)	星战火狐2 (日)
Star Ocean (J)	星海传说/银河游侠 (日)
Star Trek - Deep Space Nine - Crossroads of Time (E)	星舰迷航记-第9空间 (欧)
Star Trek - Deep Space Nine - Crossroads of Time (U) (Beta)	星舰迷航记-第9空间 测试版 (美)
Star Trek - Deep Space Nine - Crossroads of Time (U)	星舰迷航记-第9空间 (美)
Star Trek - Starfleet Academy (E)	星舰迷航记-星云学会 (欧)
Star Trek - Starfleet Academy (G)	星舰迷航记-星云学会 (德)
Star Trek - Starfleet Academy (U)	星舰迷航记-星云学会 (美)
Star Trek - The Next Generation - Future's Past (E)	星舰迷航记-另一个世代 (欧)
Star Trek - The Next Generation - Future's Past (U)	星舰迷航记-另一个世代 (美)
Stardust Suplex (J)	幻象女子摔角 (日)
Stargate (E) (M3)	星际之门 (欧)
Stargate (J)	星际之门 (日)
Stargate (U) (Beta)	星际之门 测试版 (美)
Stargate (U)	星际之门 (美)
Starwing - Super Weekend Competition (E)	星战火狐-比赛版 (欧)
Starwing - Super Weekend Competition (G)	星战火狐-比赛版 (德)
Starwing (E) (v1.0)	星战火狐 1.0版 (欧)
Starwing (E) (v1.1)	星战火狐 1.1版 (欧)
Starwing (G)	星战火狐 (德)
Stealth (J)	秘密行动 (日)
Steel Talons (U)	钢爪直升机 (美)
Sterling Sharpe End 2 End (U)	美国足球终极对决 (美)
Steven Seagal is the Final Option (U) (Beta)	魔鬼战将 测试版 (美)
Stone Protectors (J) (Beta)	摇滚保护者 测试版 (日)
Stone Protectors (U)	摇滚保护者 (美)
Street Combat (E)	街头战斗 (欧)
Street Combat (U)	街头战斗 (美)
Street Fighter Alpha 2 (E)	快打旋风2 (欧)
Street Fighter Alpha 2 (U)	快打旋风2 (美)
Street Fighter II - The World Warrior (E)	快打旋风2 (欧)
Street Fighter II - The World Warrior (J)	快打旋风2 (日)
Street Fighter II - The World Warrior (U)	快打旋风2 (美)
Street Fighter II Turbo - Hyper Fighting (E) (v1.0)	快打旋风2-加强版 1.0版 (欧)
Street Fighter II Turbo - Hyper Fighting (E) (v1.1)	快打旋风2-加强版 1.1版 (欧)
Street Fighter II Turbo - Hyper Fighting (J)	快打旋风2-加强版 (日)
Street Fighter II Turbo - Hyper Fighting (U)	快打旋风2-加强版 (美)
Street Fighter Zero 2 (J)	快打旋风-原点2 (日)
Street Hockey '95 (U) [BB03]	街头曲棍球95 (美)[BB03]
Street Hockey '95 (U) [C880]	街头曲棍球95 (美)[C880]
Street Racer (E)	街头赛车手 (欧)
Street Racer (J)	街头赛车手 (日)
Street Racer (U) (Beta)	街头赛车手 测试版 (美)
Street Racer (U)	街头赛车手 (美)
Strike Gunner S.T.G (J)
Strike Gunner S.T.G (U)
Striker (E) (M7) (Beta)	胜利足球 测试版 (欧)
Striker (E) (M7)	胜利足球 (欧)
Stunt Race FX (E)	特技立体赛车 (欧)
Stunt Race FX (U) (v1.1)	特技立体赛车 1.1版 (美)
Sufami Turbo Add-On Base Cassette (J)
Sugoi Hebereke (J)	魔法气泡小人物对决 (日)
Sugoro Quest++ - Dicenics (J)	勇者传说 (日)
Sugoroku Ginga Senki (J)	银河战记 (日)
Sun Sport Fishing - Keiryuu Ou (J)	溪流王 (日)
Sunset Riders (E)	日落骑士 (欧)
Sunset Riders (U)	日落骑士 (美)
Supapoon (J)	超立体打砖块 (日)
Supapoon DX (J)	超立体打砖块DX (日)
Super 3D Baseball (J)	超级3D棒球 (日)
Super 3D Noah's Ark (U) (Unl)	诺亚方舟3D总部 (美)
Super 4WD - The Baja (J)	超级四轮赛车 (日)
Super Adventure Island (E)	超级冒险岛 (欧)
Super Adventure Island (U)	超级冒险岛 (美)
Super Adventure Island II (E)	超级冒险岛2 (欧)
Super Adventure Island II (U)	超级冒险岛2 (美)
Super Air Diver (E)	超级空中战斗员 (欧)
Super Air Diver (J)	超级空中战斗员 (日)
Super Air Diver 2 (J)	超级空中战斗员2 (日)
Super Aleste (E)	太空争霸 (欧)
Super Aleste (J)	太空争霸 (日)
Super Alfred Chicken (U)	神险艾烈佛 (美)
Super Aoki Ookami to Shiroki Mejika - Genchou Hishi (J)	元朝密史-蒼狼与白鹿 (日)
Super Aquatic Games, The (U) (Beta)	爆笑海底城运动会 测试版 (美)
Super Aquatic Games, The (U)	爆笑海底城运动会 (美)
Super B.C. Kid (E)	超级原人 (欧)
Super Back to the Future Part II (J)	回到未来2 (日)
Super Baken Ou '95 (J)	超级马券王95 (日)
Super Baseball Simulator 1000 (U)	超级虚拟棒球1000 (美)
Super Bases Loaded (U)	超级基础棒球 (美)
Super Bases Loaded 3 - License to Steal (U) (v1.0)	超级基础棒球3 1.0版 (美)
Super Bases Loaded 3 - License to Steal (U) (v1.1) [b]	超级基础棒球3 1.1版 (美)
Super Bases Loaded II (U)	超级基础棒球2 (美)
Super Batter Up (U)	超级强棒 (美)
Super Battleship (E)	超级战舰 (欧)
Super Battleship (U)	超级战舰 (美)
Super Battletank - War in the Gulf (U) (v1.0)	超级坦克 1.0版 (美)
Super Battletank - War in the Gulf (U) (v1.1)	超级坦克 1.1版 (美)
Super Battletank (E)	超级坦克 (欧)
Super Battletank (J)	超级坦克 (日)
Super Battletank 2 (E)	超级坦克2 (欧)
Super Battletank 2 (J)	超级坦克2 (日)
Super Battletank 2 (S)	超级坦克2 (S)
Super Battletank 2 (U)	超级坦克2 (美)
Super Bikkuriman (J)	超级比卡鲁超人 (日)
Super Billiard Championship Pool (J)	超级撞球台 (日)
Super Birdie Rush (J)	超级博蒂高尔夫 (日)
Super Black Bass (J)	超级黑巴斯 (日)
Super Black Bass (U)	超级黑巴斯 (美)
Super Black Bass 2 (J)	超级黑巴斯2 (日)
Super Black Bass 3 (J) (v1.0)	超级黑巴斯3 1.0版 (日)
Super Black Bass 3 (J) (v1.1)	超级黑巴斯3 1.1版 (日)
Super Bomberman - Panic Bomber W (J)	轰炸超人 (日)
Super Bomberman (E)	轰炸超人 (欧)
Super Bomberman (J)	轰炸超人 (日)
Super Bomberman (U)	轰炸超人 (美)
Super Bomberman 2 - Caravan Event Ban (J)	轰炸超人2 (日)
Super Bomberman 2 (E)	轰炸超人2 (欧)
Super Bomberman 2 (J)	轰炸超人2 (日)
Super Bomberman 2 (U)	轰炸超人2 (美)
Super Bomberman 3 (E)	轰炸超人3 (欧)
Super Bomberman 3 (J) [8452]	轰炸超人3 (日)
Super Bomberman 3 (J) [89FE]	轰炸超人3 (日)
Super Bomberman 4 (J)	轰炸超人4 (日)
Super Bomberman 5 - Caravan Event Ban (J)	轰炸超人5 (日)
Super Bomberman 5 (J)	轰炸超人5 (日)
Super Bombliss (J)	轰炸俄罗斯方块 (日)
Super Bonk (U)	超级原人 (美)
Super Bowling (J)	超级保龄球 (日)
Super Bowling (U)	超级保龄球 (美)
Super Buster Bros. (U) (v1.0)	魔鬼汽球 1.0版 (美)
Super Buster Bros. (U) (v1.1)	魔鬼汽球 1.1版 (美)
Super Caesars Palace (U) (Beta)	超级赌城 测试版 (美)
Super Caesars Palace (U)	超级赌城 (美)
Super Casino - Caesars Palace (J) (v1.0)	超级赌城 1.0版 (日)
Super Casino - Caesars Palace (J) (v1.1)	超级赌城 1.1版 (日)
Super Casino 2 (J)	超级赌城2 (日)
Super Castles (J)	超级城堡 (日)
Super Castlevania IV (E)	超级恶魔城4 (欧)
Super Castlevania IV (U)	超级恶魔城4 (美)
Super Chase H.Q. (E)	超级追踪HQ (欧)
Super Chase H.Q. (U)	超级追踪HQ (美)
Super Chinese Fighter (J)	超级中国人格斗 (日)
Super Chinese World (J)	超级中国人世界 (日)
Super Chinese World 2 - Uchuu Ichibu Toudaikai (J) (Sample)	超级中国人世界2 (日)
Super Chinese World 2 - Uchuu Ichibu Toudaikai (J)	超级中国人世界2 (日)
Super Chinese World 3 (J)	超级中国人世界3 (日)
Super Conflict - The Mideast (E)	火线冲突 (欧)
Super Conflict - The Mideast (U)	火线冲突 (美)
Super Copa (B) (M2)
Super Cup Soccer (J)	超级杯足球 (日)
Super Daikoukai Jidai (J)	超级大航海时代 (日)
Super Dany (F) (Beta)	超级丹尼 测试版 (法)
Super Dany (F)	超级丹尼 (法)
Super Dogfight (J)	超级混战 (日)
Super Donkey Kong (J) (v1.0)	超级大金刚1 (日)
Super Donkey Kong (J) (v1.1)	超级大金刚1 (日)
Super Donkey Kong 2 - Dixie & Diddy (J) (v1.0)	超级大金刚2 1.0版 (日)
Super Donkey Kong 2 - Dixie & Diddy (J) (v1.1)	超级大金刚2 1.1版(日)
Super Donkey Kong 3 - Nazo no Krems-tou (J) (v1.0)	超级大金刚3 1.0版 (日)
Super Donkey Kong 3 - Nazo no Krems-tou (J) (v1.1)	超级大金刚3 1.1版 (日)
Super Double Dragon (E) [4BB6]	超级双截龙 (欧)
Super Double Dragon (E) [D481]	超级双截龙 (欧)
Super Double Dragon (U)	超级双截龙 (美)
Super Double Yakuman (J)	超级双重役满 (日)
Super Double Yakuman II (J)	超级双重役满2 (日)
Super Drakkhen (J)	超级屠龙传记2 (日)
Super Drift Out - World Rally Chamipionships (J)	超级世界野外赛车 (日)
Super Dropzone (E)
Super Dunk Shot (J)	超级射篮 (日)
Super Dunk Star (J)	超级灌篮之星 (日)
Super Earth Defense Force (E)
Super Earth Defense Force (J)
Super Earth Defense Force (U)
Super F1 Circus (J)	超级F1竞技场 (日)
Super F1 Circus 2 (J)	超级F1竞技场2 (日)
Super F1 Circus 3 (J)	超级F1竞技场3 (日)
Super F1 Circus Gaiden (J)	超级F1竞技场外传 (日)
Super F1 Circus Limited (J)	超级F1竞技场限定版 (日)
Super F-1 Hero (J)	超级F1英雄 (日)
Super Famicom Controller Test Program (J)
Super Famicom Wars (J) (NP)	超级任天堂大战 (日)
Super Family Circuit (J)	超级巡迴赛 (日)
Super Family Gelaende (J) (NP)	超级滑雪 (日)
Super Family Tennis (J)	超级网球 (日)
Super Famista (J)	拿姆科棒球 (日)
Super Famista 2 (J)	拿姆科棒球2 (日)
Super Famista 3 (J)	拿姆科棒球3 (日)
Super Famista 4 (J) (v1.0)	拿姆科棒球4 1.0版 (日)
Super Famista 4 (J) (v1.1)	拿姆科棒球4 1.1版 (日)
Super Famista 5 (J)	拿姆科棒球5 (日)
Super Final Match Tennis (J)	超级回合网球 (日)
Super Fire Pro Wrestling - Queen's Special (J)	超火爆摔角女王 (日)
Super Fire Pro Wrestling (J)	超火爆摔角 (日)
Super Fire Pro Wrestling 2 (J)	超火爆摔角2 (日)
Super Fire Pro Wrestling III - Easy Type (J)	超火爆摔角3 (日)
Super Fire Pro Wrestling III - Final Bout (J) (v1.0)	超火爆摔角3 1.0版 (日)
Super Fire Pro Wrestling III - Final Bout (J) (v1.1)	超火爆摔角3 1.1版 (日)
Super Fire Pro Wrestling Special (J)	超火爆摔角特别版 (日)
Super Fire Pro Wrestling X (J)	超火爆摔角X (日)
Super Fire Pro Wrestling X Premium (J)	超火爆摔角超值版 (日)
Super Fishing - Big Fight (J)	超级钓鱼 (日)
Super Formation Soccer (J)	超统构足球 (日)
Super Formation Soccer '94 - World Cup Final Data (J)	超统构足球94最后资料版 (日)
Super Formation Soccer '94 (J)	超统构足球94 (日)
Super Formation Soccer '95 della Serie A - UCC Xaqua Version (J)	超统构足球95含UCC广告版 (日)
Super Formation Soccer '95 della Serie A (J)	超统构足球95 (日)
Super Formation Soccer '96 - World Club Edition (J)	超统构足球96 (日)
Super Formation Soccer II (J)	超统构足球 (日)
Super Full Metal (E) (M2) (Beta)	超级金属之战 测试版 (欧)
Super Gachapon World - SD Gundam X (J)
Super Genjin (J)	超原人 (日)
Super Genjin 2 (J)	超原人2 (日)
Super Ghouls'n Ghosts (E)	超魔界村 (欧)
Super Ghouls'n Ghosts (U)	超魔界村 (美)
Super Goal! (E)	超级足球 (欧)
Super Goal! 2 (U)	超级足球2 (美)
Super Godzilla (J) (v1.0)	超哥吉拉 1.0版 (日)
Super Godzilla (J) (v1.1)	超哥吉拉 1.1版 (日)
Super Godzilla (U)	超哥吉拉 (美)
Super Gomoku Narabe - Renju (J)	超级五目连珠 (日)
Super Gomoku Shougi - Jouseki Kenkyuu Hen (J)	超级五目将棋 (日)
Super Gussun Oyoyo (J) (Sample)	超级豆豆君 (日)
Super Gussun Oyoyo (J)	超级豆豆君 (日)
Super Gussun Oyoyo 2 (J)	超级豆豆君2 (日)
Super H.Q. - Criminal Chaser (J)
Super Hanafuda (J)	超级花札 (日)
Super Hanafuda 2 (J)	超级花札2 (日)
Super High Impact (J)	超级冲撞美式足球 (日)
Super High Impact (U) (Beta)	超级冲撞美式足球 测试版 (美)
Super High Impact (U)	超级冲撞美式足球 (美)
Super Hockey (E)	超级冰上曲棍球 (欧)
Super Hockey '94 (J)	超级冰上曲棍球94 (日)
Super Honmei - GI Seiha (J)	超级本命-G1制霸 (日)
Super Ice Hockey (E)	超级冰上曲棍球 (欧)
Super Igo - Go Ou (J)	超级基王 (日)
Super Indy Champ (J)	超级印地冠军赛车 (日)
Super Inindou - Datou Nobunaga (J)	超级伊忍道 (日)
Super International Cricket (E) [798F]	超级国际板球赛 (欧)[798F]
Super International Cricket (E) [FA4A]	超级国际板球赛 (欧)[FA4A]
Super James Pond (U) (Beta)	超级詹姆斯庞德 测试版 (美)
Super James Pond (U)	超级詹姆斯庞德 (美)
Super James Pond II (E)	超级詹姆斯庞德2 (欧)
Super James Pond II (J)	超级詹姆斯庞德2 (日)
Super Jangou (J)
Super Jinsei Game (J) (v1.0)	超级人生游戏 1.0版 (日)
Super Jinsei Game (J) (v1.1)	超级人生游戏 1.1版 (日)
Super Jinsei Game 2 (J)	超级人生游戏2 (日)
Super Jinsei Game 3 (J)	超级人生游戏3 (日)
Super Keiba (J)	超级竞马 (日)
Super Keiba 2 (J)	超级竞马2 (日)
Super Keirin (J)	超级竞轮 (日)
Super Kick Boxing - Best of the Best (J)	超级泰国拳 (日)
Super Kick Off (J)	超级射网 (日)
Super Koukou Yakyuu - Ikkyuu Nyuukon (J)	超级高校野球-一球入魂 (日)
Super Kyousouba - Kaze no Sylphid (J)	超级竞走马 (日)
Super Kyoutei (J)	超级竞艇 (日)
Super Kyoutei 2 (J)	超级竞艇2 (日)
Super Kyuukyoku Harikiri Stadium (J)	超究极棒球 (日)
Super Kyuukyoku Harikiri Stadium 2 (J)	超究极棒球2 (日)
Super Linearball (J)	太空足球 (日)
Super Loopz (J)	水管拼图 (日)
Super Mad Champ (J)	超级疯狂机车赛 (日)
Super Mahjong (J)	超级麻将 (日)
Super Mahjong 2 - Honkaku 4 Nin Uchi (J)	超级麻将2-本格四人打 (日)
Super Mahjong 3 - Karakuchi (J)	超级麻将3 (日)
Super Mahjong Taikai (J) (v1.0)	超级麻将大会 1.0版 (日)
Super Mahjong Taikai (J) (v1.3)	超级麻将大会 1.3版 (日)
Super Mario - Yossy Island (J) (v1.0)	超级马里奥耀西之岛 1.0版 (日)
Super Mario - Yossy Island (J) (v1.1)	超级马里奥耀西之岛 1.1版 (日)
Super Mario - Yossy Island (J) (v1.2)	超级马里奥耀西之岛 1.2版 (日)
Super Mario All-Stars (E)	马里奥明星大集合 (欧)
Super Mario All-Stars (U)	马里奥明星大集合 (美)
Super Mario All-Stars + Super Mario World (E)	马里奥明星大集合 (欧)
Super Mario All-Stars + Super Mario World (U)	马里奥明星大集合 (美)
Super Mario Collection (J) (v1.0)	马里奥明星大集合 1.0版 (日)
Super Mario Collection (J) (v1.1)	马里奥明星大集合 1.1版 (日)
Super Mario Kart (E)	马里奥赛车 (欧)
Super Mario Kart (J)	马里奥赛车 (日)
Super Mario Kart (U)	马里奥赛车 (美)
Super Mario RPG - Legend of the Seven Stars (U)	马里奥RPG (美)
Super Mario RPG (J)	马里奥RPG (日)
Super Mario World (E) (v1.0)	马里奥世界 1.0版 (欧)
Super Mario World (E) (v1.1)	马里奥世界 1.1版 (欧)
Super Mario World (J)	马里奥世界 (日)
Super Mario World (U)	马里奥世界 (美)
Super Mario World 2 - Yoshi's Island (E) (M3) (v1.0)	马里奥世界2 1.0版 (欧)
Super Mario World 2 - Yoshi's Island (E) (M3) (v1.1)	马里奥世界2 1.1版 (欧)
Super Mario World 2 - Yoshi's Island (U) (v1.0)	马里奥世界2 1.0版 (美)
Super Mario World 2 - Yoshi's Island (U) (v1.1)	马里奥世界2 1.1版 (美)
Super Metroid (E) (M3)	超级银河战士 (欧)
Super Metroid (JU) (M2)	超级银河战士 (日)
Super Moero!! Pro Yakyuu (J)	超燃烧野球 (日)
Super Momotarou Dentetsu DX (J)	超级桃太郎电铁DX (日)
Super Momotarou Dentetsu II (J)	超级桃太郎电铁2 (日)
Super Momotarou Dentetsu III (J) (v1.0)	超级桃太郎电铁3 1.0版 (日)
Super Momotarou Dentetsu III (J) (v1.1)	超级桃太郎电铁3 1.1版 (日)
Super Momotarou Dentetsu III (J) (v1.2)	超级桃太郎电铁3 1.2版 (日)
Super Morph (E)	水的三态变化 (欧)
Super Naxat Open - Golf de Shoubu da Dorabot-chan (J)	超级魔法高尔夫 (日)
Super Nazo Puyo - Lulu no Lu (J)	魔法气泡物语 (日)
Super Nazo Puyo Tsuu - Lulu no Tetsuwan Hanjouki (J)	魔法气泡物语2 (日)
Super NES Test Program (U)	超任测试工具选单 (美)
Super Nichibutsu Mahjong (J)	超写实麻雀 (日)
Super Nichibutsu Mahjong 2 - Zenkoku Seiha Hen (J)	超写实麻雀2 (日)
Super Nichibutsu Mahjong 3 - Yoshimoto Gekijou Hen (J)	超写实麻雀3 (日)
Super Nichibutsu Mahjong 4 - Kisokenkyuu Hen (J)	超写实麻雀4 (日)
Super Ninja Boy (U)	超级中国人 (美)
Super Ninja-kun (J)	超级忍者君 (日)
Super Nobunaga no Yabou - Bushou Fuuunroku (J)	信长之野望-武将风云录 (日)
Super Nobunaga no Yabou - Zenkoku Ban (J)	超级信长之野望-全国版 (日)
Super Nova (U)	太空战斗机 (美)
Super Off Road - The Baja (U) (Beta)	超级四轮巨无霸赛车 测试版 (美)
Super Off Road - The Baja (U)	超级四轮巨无霸赛车 (美)
Super Off Road (E)	超级四轮巨无霸赛车 (欧)
Super Off Road (J)	超级四轮巨无霸赛车 (日)
Super Off Road (U)	超级四轮巨无霸赛车 (美)
Super Okumanchouja Game (J)	超级亿万长者游戏 (日)
Super Oozumou - Nessen Daiichiban (J)	超级大相扑-热战大一番 (日)
Super Pachinko (J)	超级柏青哥 (日)
Super Pachinko Taisen (J)	超级柏青哥大战 (日)
Super Pachi-Slot Mahjong (J)	超级水果盘&麻将 (日)
Super Pang (E)	魔鬼汽球 (欧)
Super Pang (J)	魔鬼汽球 (日)
Super Pinball - Behind the Mask (E)	面具后的弹珠台 (欧)
Super Pinball - Behind the Mask (J) [4571]	面具后的弹珠台 (日)
Super Pinball - Behind the Mask (J) [F9D1]	面具后的弹珠台 (日)
Super Pinball - Behind the Mask (U) (v1.0)	面具后的弹珠台 (美)
Super Pinball - Behind the Mask (U) (v1.1)	面具后的弹珠台 (美)
Super Pinball II - The Amazing Odyssey (J)	超级弹珠台2 (日)
Super Play Action Football (U)	超动感足球 (美)
Super Power League (J)	超动力联盟棒球 (日)
Super Power League 2 (J) (v1.0)	超动力联盟棒球2 1.0版 (日)
Super Power League 2 (J) (v1.1)	超动力联盟棒球2 1.1版 (日)
Super Power League 3 (J)	超动力联盟棒球3 (日)
Super Probotector - Alien Rebels (E)	超级魂斗罗 (欧)
Super Professional Baseball (J)	超级职业棒球 (日)
Super Professional Baseball II (J)	超级职业棒球2 (日)
Super Punch-Out!! (E)	技术击倒 (欧)
Super Punch-Out!! (J) (NP)	技术击倒 (日)
Super Punch-Out!! (U)	技术击倒 (美)
Super Putty (E) (Beta) [h]	超级点点君 测试版 (欧)
Super Putty (E)	超级点点君 (欧)
Super Putty (U)	超级点点君 (美)
Super Puyo Puyo (J) (v1.0)	魔法气泡 1.0版 (日)
Super Puyo Puyo (J) (v1.1)	魔法气泡 1.1版 (日)
Super Puyo Puyo (J) (v1.2)	魔法气泡 1.2版 (日)
Super Puyo Puyo Tsuu (J)
Super Puyo Puyo Tsuu Remix (J)
Super R.B.I. Baseball (U)	超级RBI棒球 (美)
Super Real Mahjong PIV (J)	超真实麻雀P4 (日)
Super Real Mahjong PV Paradise - All-Star 4 Nin Uchi (J)	超真实麻雀P4 (日)
Super Robot Taisen EX (J)	超级机器人大战EX (日)
Super Robot Taisen Gaiden - Masou Kishin - The Lord of Elemental (J)	魔装机神-原吸出错误版 (日)
Super Royal Blood (J)	超级领国战 (日)
Super R-Type (E)	超级异形战机 (欧)
Super R-Type (J)	超级异形战机 (日)
Super R-Type (U)	超级异形战机 (美)
Super Rugby (J)	超级橄榄球 (日)
Super Sangokushi (J)	超级三国志 (日)
Super Sangokushi II (J) (v1.0)	超级三国志2 1.0版 (日)
Super Sangokushi II (J) (v1.1)	超级三国志2 1.1版 (日)
Super Scope 6 (J)	超级导弹6 (日)
Super Scope 6 (U)	超级导弹6 (美)
Super Shadow of the Beast (U) (Beta)	超级影子战士 测试版 (美)
Super Shanghai - Dragon's Eye (J)	超级上海-龙之眼 (日)
Super Shougi (J)	超级将棋 (日)
Super Shougi 2 (J)	超级将棋2 (日)
Super Shougi 3 - Kitaihei (J)	超级将棋3 (日)
Super Slam Dunk (U)	超级灌篮 (美)
Super Slapshot (J)	超级冰棍射网 (日)
Super Slapshot (U)	超级冰棍射网 (美)
Super Smash T.V. (E)	超级电视斗士 (欧)
Super Smash T.V. (U)	超级电视斗士 (美)
Super Snakey (J)	超级蛇方块 (日)
Super Soccer (E)	超级足球 (欧)
Super Soccer (U) (NSS)	超级足球 (美)
Super Soccer (U)	超级足球 (美)
Super Soccer Champ (U)	超级冠军足球 (美)
Super Solitaire (E) (M5)	超级扑克集锦 (欧)
Super Solitaire (U) (M5)	超级扑克集锦 (美)
Super Soukoban (J)	超级仓库番 (日)
Super Stadium (J)	超级露天棒球场 (日)
Super Star Wars - Jedi no Fukushuu (J)	星际大战4 (日)
Super Star Wars - Return of the Jedi (E) (v1.0)	星际大战6-绝地大反攻 1.0版 (欧)
Super Star Wars - Return of the Jedi (E) (v1.1)	星际大战6-绝地大反攻 1.1版 (欧)
Super Star Wars - Return of the Jedi (U) (v1.0)	星际大战6-绝地大反攻 1.0版 (美)
Super Star Wars - Return of the Jedi (U) (v1.1)	星际大战6-绝地大反攻 1.1版 (美)
Super Star Wars - Teikoku no Gyakushuu (J)	星际大战4 (日)
Super Star Wars - The Empire Strikes Back (E) (Beta)	星际大战5-帝国大反击 测试版 (欧)
Super Star Wars - The Empire Strikes Back (E)	星际大战5-帝国大反击 (欧)
Super Star Wars - The Empire Strikes Back (U) (v1.0)	星际大战5-帝国大反击 1.0版 (美)
Super Star Wars - The Empire Strikes Back (U) (v1.1)	星际大战5-帝国大反击 1.1版 (美)
Super Star Wars (E) (v1.0)	星际大战4 1.0版 (欧)
Super Star Wars (E) (v1.1)	星际大战4 1.1版 (欧)
Super Star Wars (J)	星际大战4 (日)
Super Star Wars (U) (Beta)	星际大战4 测试版 (美)
Super Star Wars (U)	星际大战4 (美)
Super Street Fighter II - The New Challengers (E)	超级快打旋风2 (欧)
Super Street Fighter II - The New Challengers (J)	超级快打旋风2 (日)
Super Street Fighter II - The New Challengers (U)	超级快打旋风2 (美)
Super Strike Eagle (E) (M5)	超级战鹰 (欧)
Super Strike Eagle (U)	超级战鹰 (美)
Super Strike Gunner (E)	S.T.G (欧)
Super SWIV (E)	超级联合部队 (欧)
Super SWIV (J)	超级联合部队 (日)
Super Tekkyuu Fight! (J)	超级铁球大战 (日)
Super Tennis - World Circuit (J)	超级网球巡迴赛 (日)
Super Tennis (E) (v1.0)	超级网球 1.0版 (欧)
Super Tennis (E) (v1.1)	超级网球 1.1版 (欧)
Super Tennis (U)	超级网球 (美)
Super Tetris 2 + Bombliss - Genteiban (J)	超级俄罗斯方块2+轰炸方块限定版 (日)
Super Tetris 2 + Bombliss (J)	超级俄罗斯方块2+轰炸方块 (日)
Super Tetris 3 (J)	超级俄罗斯方块3 (日)
Super Troll Islands (E)	超级转转岛 (欧)
Super Troll Islands (J)	超级转转岛 (日)
Super Troll Islands (U) (Beta)	超级转转岛 测试版 (美)
Super Troll Islands (U)	超级转转岛 (美)
Super Trump Collection (J)	超级游戏集锦 (日)
Super Trump Collection 2 (J)	超级游戏集锦2 (日)
Super Tsume Shougi 1000 (J)	超级詰将棋1000 (日)
Super Turrican (E)	超级战士 (欧)
Super Turrican (J)	超级战士 (日)
Super Turrican (U)	超级战士 (美)
Super Turrican 2 (E)	超级战士2 (欧)
Super Turrican 2 (U) (Beta)	超级战士2 测试版 (美)
Super Turrican 2 (U) [1B25]	超级战士2 (美)
Super Turrican 2 (U) [7F03]	超级战士2 (美)
Super Ultra Baseball (J)	超能力棒球 (日)
Super Ultra Baseball 2 (J)	超能力棒球2 (日)
Super Uno (J)	超级Uno (日)
Super Valis - Akaki Tsuki no Otome (J)	超级梦幻战士4 (日)
Super Valis IV (U)	超级梦幻战士4 (美)
Super Variable Geo (J)	姬武神传说 (日)
Super Volley II (J)	超级排球2 (日)
Super Wagan Land (J)	超级瓦强世界 (日)
Super Wagan Land 2 (J)	超级瓦强世界2 (日)
Super Widget (U)	超级威捷特 (美)
Super Wrestle Angels (J)	超级摔角天使 (日)
Super Yakyuudou (J)	超级野球道 (日)
Super Zugan - Hakotenjou Kara no Shoutaijou (J)	超级自我中心麻将 (日)
Super Zugan 2 - Tsukanpo Fighter (J)	超级自我中心麻将2 (日)
Sutobasu Yarou Show (J)	篮球天王-将 (日)
Sutte Hakkun (J) (NP)	抢救彩虹 (日)
Suzuka 8 Hours (J)	8小时机车赛 (日)
Suzuka 8 Hours (U)	8小时机车赛 (美)
Suzuki Aguri no F-1 Super Driving (J)	铃木F1超级赛车 (日)
SWAT Kats - The Radical Squadron (U)	特警先锋猫 (美)
Sword Maniac (J)	剑狂 (日)
Sword World SFC (J)	剑王之王 (日)
Sword World SFC 2 - Inishie no Kyojin Densetsu (J)	剑王之王2 (日)
Syndicate (E) (M3) [9A18]	企业联合 (欧)
Syndicate (E) (M3) [A184]	企业联合 (欧)
Syndicate (J)	企业联合 (日)
Syndicate (U)	企业联合 (美)
Syvalion (E) (Beta)	天圣龙 测试版 (欧)
Syvalion (E)	天圣龙 (欧)
Syvalion (J)	天圣龙 (日)
T2 - The Arcade Game (E)	魔鬼终结者机台版 (欧)
T2 - The Arcade Game (J)	魔鬼终结者机台版 (日)
T2 - The Arcade Game (U)	魔鬼终结者机台版 (美)
Table Game Daishuugou!! (J)	桌上游戏集锦 (日)
Tactical Soccer (J) [51F5]	策略足球 (日)
Tactical Soccer (J) [5205]	策略足球 (日)
Tactics Ogre - Let Us Cling Together (J) (v1.0)	皇家骑士团2 1.0版 (日)
Tactics Ogre - Let Us Cling Together (J) (v1.1)	皇家骑士团2 1.1版 (日)
Tactics Ogre - Let Us Cling Together (J) (v1.2)	皇家骑士团2 1.2版 (日)
Tadaima Yuusha Boshuuchuu Okawari (J)	勇者募集中 (日)
Taekwon-Do (J) (M2)	跆拳道 (日)
Taiketsu!! Brass Numbers (J)	对决!!黄金决战 (日)
Taikou Risshiden (J)	太阁立志传 (日)
Taikyoku Igo - Goliath (J)	对局定基 (日)
Taikyoku Igo - Idaten (J)	对局定基-韦驮天 (日)
Taiwan 16 Mahjong II - Horoscope Girls Edition (Unl)	16张麻将-星座女郎篇
Takahashi Meijin no Daibouken Shima (J)	高桥名人之大冒险岛 (日)
Takahashi Meijin no Daibouken Shima II (J)	高桥名人之大冒险岛2 (日)
Take Yutaka GI Memory (J)	武丰G1赛马 (日)
Takeda Nobuhiro no Super Cup Soccer (J)	武田修宏之超级杯足球 (日)
Takeda Nobuhiro no Super League Soccer (J)	武田修宏之超级联盟足球 (日)
Takemiya Masaki Kudan no Igo Taishou (J)	定基大将 (日)
Tales of Phantasia (J)	幻想传说 (日)
Tamagotchi Town (J) (NP)	宠物蛋之城 (日)
Tarot Mystery (J)	星座别相性诊所 (日)
Tatakae Genshijin 2 - Rookie no Bouken (J)	战斗原始人2 (日)
Tatakae Genshijin 3 - Shuyaku ha Yappari Joe & Mac (J)	战斗原始人3 (日)
Taz-Mania (E)	旋风狗泰茲 (欧)
Taz-Mania (U) (Beta)	旋风狗泰茲 测试版 (美)
Taz-Mania (U)	旋风狗泰茲 (美)
Tecmo Secret of the Stars (U) (Beta)	特库摩神秘之星 测试版 (美)
Tecmo Secret of the Stars (U)	特库摩神秘之星 (美)
Tecmo Super Baseball (J)	特库摩超级棒球 (日)
Tecmo Super Baseball (U) (Beta)	特库摩超级棒球 测试版 (美)
Tecmo Super Baseball (U)	特库摩超级棒球 (美)
Tecmo Super Bowl (J)	特库摩超级美式足球 (日)
Tecmo Super Bowl (U) (Beta)	特库摩超级美式足球 测试版 (美)
Tecmo Super Bowl (U)	特库摩超级美式足球 (美)
Tecmo Super Bowl II - Special Edition (J)	特库摩超级美式足球2 (日)
Tecmo Super Bowl II - Special Edition (U)	特库摩超级美式足球2 (美)
Tecmo Super Bowl III - Final Edition (J)	特库摩超级美式足球3 (日)
Tecmo Super Bowl III - Final Edition (U)	特库摩超级美式足球3 (美)
Tecmo Super NBA Basketball (A)	特库摩超级NBA篮球
Tecmo Super NBA Basketball (E)	特库摩超级NBA篮球 (欧)
Tecmo Super NBA Basketball (J) (v1.0)	特库摩超级NBA篮球 1.0版 (日)
Tecmo Super NBA Basketball (J) (v1.1)	特库摩超级NBA篮球 1.1版 (日)
Tecmo Super NBA Basketball (U)	特库摩超级NBA篮球 (美)
Teenage Mutant Hero Turtles - Tournament Fighters (E)	忍者龟5 (欧)
Teenage Mutant Hero Turtles IV - Turtles in Time (E)	忍者龟4 (欧)
Teenage Mutant Ninja Turtles - Mutant Warriors (J)	忍者龟 (日)
Teenage Mutant Ninja Turtles - Tournament Fighters (A)	忍者龟5
Teenage Mutant Ninja Turtles - Tournament Fighters (U) (Beta)	忍者龟5 测试版 (美)
Teenage Mutant Ninja Turtles - Tournament Fighters (U)	忍者龟5 (美)
Teenage Mutant Ninja Turtles - Turtles in Time (J)	忍者龟4 (日)
Teenage Mutant Ninja Turtles IV - Turtles in Time (A)	忍者龟4
Teenage Mutant Ninja Turtles IV - Turtles in Time (U) (Beta)	忍者龟4 测试版 (美)
Teenage Mutant Ninja Turtles IV - Turtles in Time (U)	忍者龟4 (美)
Teitoku no Ketsudan (J) (v1.0)	提督之决断 1.0版 (日)
Teitoku no Ketsudan (J) (v1.1)	提督之决断 1.1版 (日)
Teitoku no Ketsudan II (J) (v1.0)	提督之决断2 1.0版 (日)
Teitoku no Ketsudan II (J) (v1.1)	提督之决断2 1.1版 (日)
Tekichuu Keiba Juku (J)	的中竞马塾 (日)
Tenchi Muyou! - Game Hen (J)	天地无用 (日)
Tenchi Souzou (J)	天地创造 (日)
Tenchi wo Kurau - Sangokushi Gunyuuden (J)	吞食天地-三国群雄传 (日)
Tenryuu Genichiro no Pro Wrestling Revolution (J)
Tenshi no Uta - Shiroki Tsubasa no Inori (J)
Terminator 2 - Judgment Day (E) (Beta)	魔鬼终结者2-审判日 测试版 (欧)
Terminator 2 - Judgment Day (E)	魔鬼终结者2-审判日 (欧)
Terminator 2 - Judgment Day (U)	魔鬼终结者2-审判日 (美)
Terminator, The (E) (Beta)	魔鬼终结者 测试版 (欧)
Terminator, The (E)	魔鬼终结者 (欧)
Terminator, The (U)	魔鬼终结者 (美)
Terranigma (E)	天地创造 (欧)
Terranigma (F)	天地创造 (法)
Terranigma (G)	天地创造 (德)
Terranigma (S)	天地创造
Tetris & Dr. Mario (E)	俄罗斯方块&马利欧医生 (欧)
Tetris & Dr. Mario (U)	俄罗斯方块&马利欧医生 (美)
Tetris 2 (E)	俄罗斯闪光方块2 (欧)
Tetris 2 (U) (v1.0)	俄罗斯闪光方块2 1.0版 (美)
Tetris 2 (U) (v1.1)	俄罗斯闪光方块2 1.1版 (美)
Tetris Attack (E) (M2)	耀西俄罗斯方块 (欧)
Tetris Attack (U) (M2)	耀西俄罗斯方块 (美)
Tetris Battle Gaiden (J)	俄罗斯武斗外传 (日)
Tetris Flash (J)	俄罗斯闪光方块 (日)
Tetsuwan Atom (J)	原子小金刚 (日)
Theme Park (E) (M3)	主題乐园 (欧)
Theme Park (J)	主題乐园 (日)
Thomas the Tank Engine and Friends (E)	汤玛斯幼儿教育 (欧)
Thomas the Tank Engine and Friends (U)	汤玛斯幼儿教育 (美)
Thoroughbred Breeder (J)	育马物语 (日)
Thoroughbred Breeder II (J)	育马物语2 (日)
Thoroughbred Breeder III (J)	育马物语3 (日)
Thunder Spirits (J)	闪电出击 (日)
Thunder Spirits (U)	闪电出击 (美)
Thunderbirds - Kokusai Kyuujotai Shutsudou seyo! (J)	国际救助队 (日)
Tick, The (U)	踢克超人 (美)
Time Slip (E) (Beta)	错乱时空 测试版 (欧)
Time Slip (E)	错乱时空 (欧)
Time Slip (U)	错乱时空 (美)
Time Trax (E)	时空迷返 (欧)
Time Trax (U) (Beta)	时空迷返 测试版 (美)
Time Trax (U)	时空迷返 (美)
Timecop (E)	时空战警 (欧)
Timecop (J)	时空战警 (日)
Timecop (U)	时空战警 (美)
Timon & Pumbaa's Jungle Games (E)	提马与彭彭 (欧)
Timon & Pumbaa's Jungle Games (U)	提马与彭彭 (美)
Tin Star (U)	西部之星 (美)
Tinhead (E) (Beta)	铁头战士 测试版 (欧)
Tintin in Tibet (E) (M4)	丁丁西藏冒险 (欧)
Tiny Toon Adventures - Buster Busts Loose! (E)	顽皮兔大冒险 (欧)
Tiny Toon Adventures - Buster Busts Loose! (S)	顽皮兔大冒险
Tiny Toon Adventures - Buster Busts Loose! (U) (Beta)	顽皮兔大冒险 测试版 (美)
Tiny Toon Adventures - Buster Busts Loose! (U)	顽皮兔大冒险 (美)
Tiny Toon Adventures - Dotabata Daiundoukai (J)	顽皮兔大运动会 (日)
Tiny Toon Adventures - Wacky Sports Challenge (U)	顽皮兔大运动会 (美)
Tiny Toon Adventures - Wild & Wacky Sports (E) (Beta)	顽皮兔大运动会 测试版 (欧)
Tiny Toon Adventures - Wild & Wacky Sports (E) (v1.0)	顽皮兔大运动会 1.0版 (欧)
Tiny Toon Adventures - Wild & Wacky Sports (E) (v1.1)	顽皮兔大运动会 1.1版 (欧)
Tiny Toon Adventures (J)	顽皮兔大冒险 (日)
TKO Super Championship Boxing (E)	技术击倒超级冠军拳击 (欧)
TKO Super Championship Boxing (U)	技术击倒超级冠军拳击 (美)
TNN Bass Tournament of Champions (U)
Tokimeki Memorial - Densetsu no Ki no Shita de (J) (v1.0)	纯爱手札 1.0版 (日)
Tokimeki Memorial - Densetsu no Ki no Shita de (J) (v1.1)	纯爱手札 1.1版 (日)
Tokoro's Mahjong (J)	塔库罗麻将 (日)
Tom & Jerry (E)	汤姆与杰瑞 (欧)
Tom & Jerry (J)	汤姆与杰瑞 (日)
Tom & Jerry (U) (Beta)	汤姆与杰瑞 测试版 (美)
Tom & Jerry (U)	汤姆与杰瑞 (美)
Tony Meola's Sidekicks Soccer (U)	汤尼角落发球足球 (美)
Top Gear (E)	超越颠峰 (欧)
Top Gear (U)	超越颠峰 (美)
Top Gear 2 (E)	超越颠峰2 (欧)
Top Gear 2 (U)	超越颠峰2 (美)
Top Gear 3000 (E)	超越颠峰3000 (欧)
Top Gear 3000 (U)	超越颠峰3000 (美)
Top Management II (J)	頂尖上班族2 (日)
Top Racer (J)	超越颠峰 (日)
Top Racer 2 (J)	超越颠峰2 (日)
Torneco no Daibouken - Fushigi no Dungeon (J) (v1.0)	特內鲁克大冒险 1.0版 (日)
Torneco no Daibouken - Fushigi no Dungeon (J) (v1.1)	特內鲁克大冒险 1.1版 (日)
Total Carnage (E)	绝地大屠杀 (欧)
Total Carnage (U) [94D5]	绝地大屠杀 (美)
Total Carnage (U) [EB29]	绝地大屠杀 (美)
Tottemo! Lucky Man - Lucky Cookie Roulette de Totsugeki!! (J)	幸运超人 (日)
Touge Densetsu - Saisoku Battle (J)	最速传说 (日)
Tower Dream (J)	梦幻之塔 (日)
Toy Story (E) (M3)	玩具总动员 (欧)
Toy Story (J)	玩具总动员 (日)
Toy Story (U)	玩具总动员 (美)
Toys (E)	玩具大作战 (美)
Toys (U)	玩具大作战 (欧)
Traverse - Starlight & Prairie (J)	飞跃星光草原 (日)
Treasure Hunter G (J)	追宝猎人G (日)
Trinea (J)	三星幻界 (日)
Tri-Star Super 8 BIOS (U) (v1.0) (Unl)
Tri-Star Super 8 BIOS (U) (v1.1) (Unl)
Troddlers (E) (Beta)	所罗门之星 测试版 (欧)
Troddlers (E)	所罗门之星 (欧)
Troddlers (U)	所罗门之星 (美)
Troy Aikman NFL Football (E)	特洛伊NFL美式足球 (欧)
Troy Aikman NFL Football (U)	特洛伊NFL美式足球 (美)
True Lies (E)	魔鬼大帝 (欧)
True Lies (G)	魔鬼大帝 (德)
True Lies (J)	魔鬼大帝 (日)
True Lies (U) (Beta)	魔鬼大帝 测试版 (美)
True Lies (U)	魔鬼大帝 (美)
Trump Island (J)	流浪之岛 (日)
Tsukikomori (J)	晦 (日)
Tsuppari Oozumou - Risshin Shusse Hen (J)	大相扑-立身出世篇 (日)
Tsuri Tarou (J)	钓鱼太郎 (日)
Tsuyoshi Shikkari Shinasai - Taisen Puzzle Dama (J)	巴掌方块大战 (日)
Tuff E Nuff (E)	死亡烈斗 (欧)
Tuff E Nuff (U)	死亡烈斗 (美)
Turbo Toons (E)	动物大赛跑 (欧)
Turf Hero (J)	赛马英雄 (日)
Turf Memories (J)	赛马回忆 (日)
Turn and Burn - No-Fly Zone (E)	爆燃战机 (欧)
Turn and Burn - No-Fly Zone (U)	爆燃战机 (美)
TwinBee - Rainbow Bell Adventure (J)	兵蜂-彩虹铃当大冒险 (日)
Twisted Tales of Spike McFang, The (U)	史派克大冒险 (美)
U.F.O. Kamen Yakisoban - Kettler no Kuroi Inbou - Keihin Ban (J)	幽浮假面战士 (日)
U.F.O. Kamen Yakisoban - Kettler no Kuroi Inbou (J)	幽浮假面战士 (日)
U.N. Squadron (E)	战区88 (欧)
U.N. Squadron (U)	战区88 (美)
Uchuu no Kishi Tekkaman Blade (J) (Beta)	宇宙骑士 测试版 (日)
Uchuu no Kishi Tekkaman Blade (J)	宇宙骑士 (日)
Uchuu Race - Astro Go! Go! (J)	宇宙爆笑赛车 (日)
Ultima - Kyouryuu Teikoku (J)	创世纪恐龙帝国 (日)
Ultima - Runes of Virtue II (U) (Beta)	创世纪-神秘的美德2 测试版 (美)
Ultima - Runes of Virtue II (U)	创世纪-神秘的美德2 (美)
Ultima Gaiden - Kuro Kishi no Inbou (J)	创世纪外传 (日)
Ultima VI - Itsuwari no Yogensha (J) (Beta)	创世纪6 测试版 (日)
Ultima VI - Itsuwari no Yogensha (J)	创世纪6 (日)
Ultima VI - The False Prophet (U)	创世纪6 (美)
Ultima VII - The Black Gate (J)	创世纪7 (日)
Ultima VII - The Black Gate (U) (Beta)	创世纪7 测试版 (美)
Ultima VII - The Black Gate (U)	创世纪7 (美)
Ultimate Fighter (U)	飞龙拳 (美)
Ultimate Football (J)	终极足球 (日)
Ultimate Mortal Kombat 3 (E)	终极真人快打3 (欧)
Ultimate Mortal Kombat 3 (U)	终极真人快打3 (美)
Ultra Baseball Jitsumei Ban (J)	极端棒球实名版 (日)
Ultra Baseball Jitsumei Ban 2 (J)	极端棒球实名版2 (日)
Ultra Baseball Jitsumei Ban 3 (J)	极端棒球实名版3 (日)
Ultra League - Moero! Soccer Daikessen!! (J)	咸蛋超人联盟足球大战 (日)
Ultra Seven (J)	咸蛋超人7号 (日)
Ultraman - Towards the Future (E)	咸蛋超人-朝未来而去 (欧)
Ultraman - Towards the Future (U)	咸蛋超人-朝未来而去 (美)
Ultraman (J)	咸蛋超人 (日)
Umi no Nushi Tsuri (J)	海钓太郎 (日)
Umi Tsuri Meijin - Suzuki Hen (J)	海钓名人 (日)
Umihara Kawase (J)	海腹川背 (日)
Uncharted Waters - New Horizons (U)	大航海时代 (美)
Uncharted Waters (U)	大航海时代 (美)
Undake 30 Same Game Daisakusen - Mario Version (J)
Undercover Cops (J) [h]	未来警察 (日)
Uniracers (U)	无敌单轮车 (美)
Unirally (E)	无敌单轮车 (欧)
Universal Soldier (U) (Beta)	宇宙战士 测试版 (美)
Untouchables, The (U)	暗夜狙击 (美)
Urban Strike (E)	都市战争 (欧)
Urban Strike (U)	都市战争 (美)
USA Ice Hockey (J) (v1.0)	美国冰上曲棍球 (日)
USA Ice Hockey (J) (v1.1)	美国冰上曲棍球 (日)
Ushio to Tora (J)	魔力小马 (日)
Utopia - The Creation of a Nation (E)	殖民星球 (欧)
Utopia - The Creation of a Nation (G)	殖民星球 (德)
Utopia - The Creation of a Nation (J)	殖民星球 (日)
Utopia - The Creation of a Nation (U) (Beta)	殖民星球 测试版 (美)
Utopia - The Creation of a Nation (U)	殖民星球 (美)
Val d'Isere Championship (E) [4907]	瓦尔冠军滑雪 (欧)[4907]
Val d'Isere Championship (E) [5B66]	瓦尔冠军滑雪 (欧)[5B66]
Val d'Isere Championship (E) [E880]	瓦尔冠军滑雪 (欧)[E880]
Vegas Stakes (E)	拉斯维加斯豪赌 (欧)
Vegas Stakes (U)	拉斯维加斯豪赌 (美)
Verne World (J)	科学岛大冒险 (日)
Viking no Daimeiwaku (J)
Virtual Bart (E)	辛普森霸子的幻想 (欧)
Virtual Bart (J)	辛普森霸子的幻想 (日)
Virtual Bart (U) (Beta)	辛普森霸子的幻想 测试版 (美)
Virtual Bart (U)	辛普森霸子的幻想 (美)
Virtual Soccer (E)	虚拟足球 (欧)
Virtual Soccer (U) (Beta)	虚拟足球 测试版 (美)
Virtual Wars (J)	剪草人 (日)
Volleyball Twin (J)	超级排球&海滩排球 (日)
Vortex (E) (M2)	旋风机器人 (欧)
Vortex (J)	旋风机器人 (日)
Vortex (U) (M2)	旋风机器人 (美)
Vs. Collection (J)	鸟蛋方块 (日)
Wagan Paradise (J)	超级瓦强大冒险 (日)
Waialae Country Club (U)	瓦乐乡村俱乐部高尔夫 (美)
Waialae no Kiseki (J)	瓦乐奇蹟高尔夫 (日)
Wakataka Oozumou - Yume no Kyoudai Taiketsu (J)	若贵大相扑 (日)
Wakuwaku Ski Wonder Spur (J)	可爱滑雪大赛 (日)
Wally wo Sagase! - Ehon no Kuni no Daibouken (J)	绘本国大冒险 (日)
War 3010 - The Revolution (U)	3010大战 (美)
Waratte Iitomo! Tamorin Pick (J)	明星之梦 (日)
Wares, La (J)	真 圣刻 (日)
Wario's Woods (E)	瓦力欧的木头方块 (欧)
Wario's Woods (U)	瓦力欧的木头方块 (美)
Warlock (E)	魔法师 (欧)
Warlock (J)	魔法师 (日)
Warlock (U) (Beta) [0556]	魔法师 测试版 (美)[0556]
Warlock (U) (Beta) [9FB9]	魔法师 测试版 (美)[9FB9]
Warlock (U)	魔法师 (美)
Warp Speed (E)	空间机战 (欧)
Warp Speed (U)	空间机战 (美)
Waterworld (E)	水世界 (欧)
Wayne Gretzky and the NHLPA All-Stars (U) [D630]	威耐冰上曲棍球 (美)[D630]
Wayne Gretzky and the NHLPA All-Stars (U) [DF1C]	威耐冰上曲棍球 (美)[DF1C]
Wayne's World (E)	威耐的世界 (欧)
Wayne's World (U)	威耐的世界 (美)
WCW Super Brawl Wrestling (U)	WCW世界摔角 (美)
Weapon Lord (E)	武器大师 (欧)
Weapon Lord (U)	武器大师 (美)
Wedding Peach (J)	爱天使传说 (日)
We're Back! - A Dinosaur's Story (E)	我们回来啦-一双恐龙的故事 (欧)
We're Back! - A Dinosaur's Story (U)	我们回来啦-一双恐龙的故事 (美)
Wheel of Fortune - Deluxe Edition (U)	幸运转轮-高级版 (美)
Wheel of Fortune (U)	幸运转轮 (美)
Where in the World is Carmen Sandiego (U)	卡门圣地牙哥 (美)
Where in Time is Carmen Sandiego (U)	卡门圣地牙哥 (美)
Whirlo (E)	桑德拉大冒险 (欧)
Whizz (E)	梦游仙境兔 (欧)
Whizz (U)	梦游仙境兔 (美)
Wicked 18 (U)	邪恶18洞高尔夫 (美)
Wild Guns (E)	荒野双枪 (欧)
Wild Guns (J) (Beta)	荒野双枪 测试版 (日)
Wild Guns (J) (Sample)	荒野双枪 (日)
Wild Guns (J)	荒野双枪 (日)
Wild Guns (U)	荒野双枪 (美)
Wild Snake (U)	蛇方块 (美)
Wild Trax (J) (v1.1)	特技立体赛车 1.1版 (日)
Wile E Coyote's Revenge (E) (Beta)	大野狼与BB鸟 测试版 (欧)
Williams Arcade's Greatest Hits (E)	大型电玩合集 (欧)
Williams Arcade's Greatest Hits (U)	大型电玩合集 (美)
Wing Commander - The Secret Missions (E) (Beta)	银河飞将-秘密任务 测试版 (欧)
Wing Commander - The Secret Missions (E)	银河飞将-秘密任务 (欧)
Wing Commander - The Secret Missions (U)	银河飞将-秘密任务 (美)
Wing Commander (E)	银河飞将 (欧)
Wing Commander (G)	银河飞将 (德)
Wing Commander (J)	银河飞将 (日)
Wing Commander (U)	银河飞将 (美)
Wings 2 - Aces High (U) (Beta)	飞行俱乐部2 测试版 (美)
Wings 2 - Aces High (U)	飞行俱乐部2 (美)
Winning Post (J) (v1.0)	赛马大亨 1.0版 (日)
Winning Post (J) (v1.1)	赛马大亨 1.1版 (日)
Winning Post 2 - Program '96 (J) (v1.0)	赛马大亨2 '96 (日)
Winning Post 2 - Program '96 (J) (v1.1)	赛马大亨2 '96 (日)
Winning Post 2 (J)	赛马大亨2 (日)
Winter Extreme Skiing and Snowboarding (U)	瓦乐滑雪冠军赛 (美)
Winter Gold (E)	冬季滑雪黄金 (欧)
Winter Olympic Games - Lillehammer '94 (E) (M8)	冬季奥运94 (欧)
Winter Olympic Games - Lillehammer '94 (U) (M8)	冬季奥运94 (美)
Wizap! - Ankoku no Ou (J) [A944]	暗黑之王 (日)
Wizap! - Ankoku no Ou (J) [B2C8]	暗黑之王 (日)
Wizard of Oz, The (U)	绿野仙踪 (美)
Wizardry Gaiden IV - Taima no Kodou (J) (v1.0)
Wizardry Gaiden IV - Taima no Kodou (J) (v1.1)
Wizardry I-II-III - Story of Llylgamyn (J) (NP)	巫术123 (日)
Wizardry V - Heart of the Maelstrom (U)	巫术5 (美)
Wizardry V - Saika no Chuushin (J)	巫术5 (日)
Wizardry VI - Kindan no Mafude (J)	巫术6 (日)
Wolfchild (U)	狼童 (美)
Wolfenstein 3D (E) (Beta)	3D德军总部 测试版 (欧)
Wolfenstein 3D (E)	3D德军总部 (欧)
Wolfenstein 3D (J)	3D德军总部 (日)
Wolfenstein 3D (U)	3D德军总部 (美)
Wolverine - Adamantium Rage (E)	金刚狼 (欧)
Wolverine - Adamantium Rage (J)	金刚狼 (日)
Wolverine - Adamantium Rage (U) (Beta) [30B8]	金刚狼 测试版 (美)
Wolverine - Adamantium Rage (U) (Beta) [DE51]	金刚狼 测试版 (美)
Wolverine - Adamantium Rage (U)	金刚狼 (美)
Wonder Project J - Kikai no Shounen Pino (J)	J计划 (日)
Wondrous Magic (J)	炼金术士 (日)
Wordtris (U)	拼字方块 (美)
World Class Rugby (E)	世界级橄榄球 (欧)
World Class Rugby (F)	世界级橄榄球 (法)
World Class Rugby (J)	世界级橄榄球 (日)
World Class Rugby 2 - Kokunai Gekitou Hen '93 (J)	世界级橄榄球2' 93 (日)
World Cup Striker (E) (M3) (Beta)	世界杯足球 测试版 (欧)
World Cup Striker (E) (M3)	世界杯足球 (欧)
World Cup Striker (J)	世界杯足球 (日)
World Cup USA '94 (E) (M8)	94美国世界杯足球 (欧)
World Cup USA '94 (J)	94美国世界杯足球 (日)
World Cup USA '94 (U)	94美国世界杯足球 (美)
World Heroes (E)	英雄榜 (欧)
World Heroes (J)	英雄榜 (日)
World Heroes (U)	英雄榜 (美)
World Heroes 2 (J)	英雄榜2 (日)
World Heroes 2 (U) (Beta)	英雄榜2 测试版 (美)
World Heroes 2 (U)	英雄榜2 (美)
World League Basketball (E)	世界联盟篮球 (欧)
World League Soccer (U)	世界联盟足球 (美)
World Masters Golf (E)	世界大师极高尔夫 (欧)
World Soccer (E)	世界足球 (欧)
World Soccer (J)	世界足球 (日)
World Soccer '94 - Road to Glory (U)	94世界足球-光荣之路 (美)
Worms (E)	百战天虫 (欧)
Wrecking Crew '98 (J) (NP)
WWF Raw (E)	WWF摔角大战 (欧)
WWF Raw (U)	WWF摔角大战 (美)
WWF Royal Rumble (E)	WWF皇家摔角 (欧)
WWF Royal Rumble (J)	WWF皇家摔角 (日)
WWF Royal Rumble (U)	WF皇家摔角 (美)
WWF Super WrestleMania (E)	WWF超级摔角 (欧)
WWF Super WrestleMania (J)	WWF超级摔角 (日)
WWF Super WrestleMania (U)	WWF超级摔角 (美)
WWF WrestleMania (E)	WWF疯狂摔角 (欧)
WWF WrestleMania (J)	WWF疯狂摔角 (日)
WWF WrestleMania (U)	WWF疯狂摔角 (美)
X Zone (E)	X空间 (欧)
X Zone (U)	X空间 (美)
Xak - The Art of Visual Stage (J)	沙克传说 (日)
Xardion (U)	超攻合神 (美)
X-Kaliber 2097 (E)	剑狂 (欧)
X-Kaliber 2097 (U) (Beta)	剑狂 测试版 (美)
X-Kaliber 2097 (U)	剑狂 (美)
X-Men - Mutant Apocalypse (E)	X战警-变种末世录 (欧)
X-Men - Mutant Apocalypse (J)	X战警-变种末世录 (日)
X-Men - Mutant Apocalypse (U)	X战警-变种末世录 (美)
Yadamon - Wonderland Dreams (J)	雅达蒙梦幻仙境 (日)
Yakouchuu (J)	夜光虫 (日)
Yam Yam (J)	亚蒙亚蒙世界 (日)
Yamaneko Bubsy no Daibouken (J)
Yogi Bear (J)	亚吉熊 (日)
Yogi Bear's Cartoon Capers (E)	亚吉熊 (欧)
Yokoyama Mitsuteru - Sangokushi (J)	橫山光辉三国志 (日)
Yokoyama Mitsuteru - Sangokushi 2 (J)	橫山光辉三国志 (日)
Yokoyama Mitsuteru - Sangokushi Bangi - Sugoroku Eiyuuki (J)
Yokozuna Monogatari (J)	橫网物语 (日)
Yoshi no Cookie (J)
Yoshi no Kuruppon - Oven de Cookie (J)	耀西的烤炉 (日)
Yoshi no Road Hunting (J)
Yoshi's Cookie (E)	耀西的饼干 (欧)
Yoshi's Cookie (U)	耀西的饼干 (美)
Yoshi's Safari (E)	耀西的旅行 (欧)
Yoshi's Safari (U)	耀西的旅行 (美)
Youchien Senki Madara (J)	摩陀罗-幼稚园战记 (日)
Youkai Buster - Ruka no Daibouken (J)	露卡大冒险 (日)
Young Merlin (E)	少年梅林 (欧)
Young Merlin (U)	少年梅林 (美)
Ys III - Wanderers from Ys (J)	伊苏国3 (日)
Ys III - Wanderers from Ys (U)	伊苏国3 (美)
Ys IV - Mask of the Sun (J)	伊苏国4 (日)
Ys V - Expert (J)	伊苏国5 (日)
Ys V - Ushinawareta Suna no Miyako Kefin (J)	伊苏国5 (日)
Yume Maboroshi no Gotoku (J)	如梦似幻 (日)
Yuu Yuu Hakusho - Tokubetsu Hen (J)	幽游白书-特别篇 (日)
Yuu Yuu Hakusho (J)	幽游白书 (日)
Yuu Yuu Hakusho 2 - Kakutou no Shou (J)	幽游白书2 (日)
Yuu Yuu Hakusho Final - Makai Saikyou Retsuden (J)	幽游白书-魔界最强列传 (日)
Yuujin Janjuu Gakuen (J)	游人雀兽学园 (日)
Yuujin Janjuu Gakuen 2 (J)	游人雀兽学园2 (日)
Yuujin no Furi Furi Girls (J)	游人女孩盘戏 (日)
Yuuyu no Quiz de Go! Go! (J)	悠悠问答 (日)
Zakuro no Aji (J)	石榴之味 (日)
Zan II Spirits (J)	斩2 (日)
Zan III Spirits (J)	斩3 (日)
Zelda no Densetsu - Kamigami no Triforce (J) (v1.0)	塞尔达传说 1.0版 (日)
Zelda no Densetsu - Kamigami no Triforce (J) (v1.1)	塞尔达传说 1.1版 (日)
Zelda no Densetsu - Kamigami no Triforce (J) (v1.2)	塞尔达传说 1.2版 (日)
Zenkoku Juudan Ultra Shinri Game (J)	全国从断心理游戏 (日)
Zenkoku Koukou Soccer (J)	全国高校足球 (日)
Zenkoku Koukou Soccer 2 (J)	全国高校足球2 (日)
Zen-Nihon GT Senshuken (J)	全日本GT选手權 (日)
Zen-Nihon Pro Wrestling - Fight da Pon! (J)	全日本摔角 (日)
Zen-Nihon Pro Wrestling' - Sekai Saikyou Tag (J)	全日本摔角 (日)
Zen-Nihon Pro Wrestling (J)	全日本摔角 (日)
Zen-Nihon Pro Wrestling 2 - 3-4 Budoukan (J)	全日本摔角2-3月4号武道館 (日)
Zero 4 Champ RR (J)	房车大赛RR (日)
Zero 4 Champ RR-Z (J)	房车大赛RR-Z (日)
Zero the Kamikaze Squirrel (E) (v1.0)	零式特攻队 1.0版 (欧)
Zero the Kamikaze Squirrel (E) (v1.1)	零式特攻队 1.1版 (欧)
Zero the Kamikaze Squirrel (U)	零式特攻队 (美)
Zico Soccer (J)	瑞哥足球 (日)
Zig Zag Cat - Dachou Club mo Oosawagi da (J)	打砖块战士 (日)
Zombies (E) (Beta)	邻居不是人 测试版 (欧)
Zombies (E)	邻居不是人 (欧)
Zombies Ate My Neighbors (U)	邻居不是人 (美)
Zool - Ninja of the Nth Dimension (E)	真宝珠小子 (欧)
Zool - Ninja of the Nth Dimension (U) (Sample)	真宝珠小子 (美)
Zool - Ninja of the Nth Dimension (U)	真宝珠小子 (美)
Zool no Yume Bouken (J)	真宝珠小子 (日)
Zoop (E)	三角射击方块 (欧)
Zoop (U)	三角射击方块 (美)
Zootto Mahjong! (J) (NP)	动物麻将 (日)